Word	Type
Adelaide	Thing
Afghanistan	location_n1
Africa	Thing
Alabama	location_n1
Alaska	location_n1
Albania	Thing
Albany	Thing
Alberta	location_n1
Algeria	Thing
Amarillo	Thing
Amazon	Thing
America	location_n1
Andorra	Thing
Angola	Thing
Angolan	person_n1
Antarctica	Thing
April	period_n1
Arabian	person_n1
Argentina	location_n1
Arizona	Thing
Arkansas	location_n1
Armenia	Thing
Asia	Thing
Asian	person_n1
Asiatic	person_n1
Assam	Thing
Atlantic	Thing
August	period_n1
Austin	location_n1
Australia	location_n1
Australian	person_n1
Austria	Thing
Azerbaijan	Thing
Bahamas	location_n1
Bahamian	person_n1
Bahrain	Thing
Bangladesh	Thing
Barbary	Thing
Beijing	Thing
Belarus	Thing
Belgium	Thing
Belize	Thing
Benin	Thing
Berkeley	Thing
Berkshire	Thing
Bhutan	Thing
Bissau	Thing
Bolivian	person_n1
Bosnia	Thing
Boston	Thing
Botswana	Thing
Bronx	Thing
Brunei	Thing
Brunswick	Thing
Bryan	Thing
Bulgaria	Thing
Burma	Thing
Burmese	person_n1
Burundi	location_n1
Caledonia	Thing
California	location_n1
Cambodia	Thing
Cambrian	Thing
Cameroon	Thing
Campeche	Thing
Canada	location_n1
Caribbean	water_n2
Carolina	Thing
Caspian	Thing
Chicago	location_n1
Chile	Thing
Chilean	person_n1
Chongqing	Thing
Colombia	location_n1
Colorado	Thing
Columbia	Thing
Connecticut	location_n1
Cooperstown	Thing
Cornwall	Thing
Croatia	Thing
Cuba	Thing
Cumbria	Thing
Cyprus	Thing
Dakota	Thing
Dallas	Thing
Darwin	Thing
Dawson	Thing
December	period_n1
Delaware	location_n1
Denmark	Thing
Denver	Thing
Devon	Thing
Djibouti	Thing
Dominica	Thing
Dominican	person_n1
Durango	Thing
Durham	Thing
Ecuador	location_n1
Egypt	location_n1
Egyptian	person_n1
England	location_n1
Eritrea	Thing
Essex	Thing
Estonia	location_n1
Ethiopia	location_n1
Ethiopian	person_n1
Eurasia	Thing
Europe	Thing
Fe	element_n2
February	period_n1
Fiji	Thing
Finland	location_n1
Florida	location_n1
France	location_n1
Fresno	Thing
Friday	period_n1
Gabon	Thing
Gambia	Thing
Gambian	person_n1
Gansu	Thing
Georgia	Thing
Germany	location_n1
Ghana	Thing
Gloucestershire	Thing
Gondwanaland	Thing
Greece	Thing
Grenada	Thing
Guangdong	Thing
Guatemala	Thing
Guayaquil	Thing
Guiana	Thing
Guinean	person_n1
Guyana	location_n1
Haiti	Thing
Haitian	person_n1
Hampshire	Thing
Hawaii	location_n1
Hebei	Thing
Hershey	Thing
Hertfordshire	Thing
Holland	Thing
Honduras	location_n1
Houston	location_n1
Hunan	Thing
Hungary	Thing
Iceland	location_n1
Idaho	location_n1
Illinois	location_n1
India	location_n1
Indian	person_n1
Indiana	Thing
Indonesia	Thing
Indonesian	person_n1
Iowa	location_n1
Iran	Thing
Iraq	Thing
Ireland	location_n1
Israel	Thing
Italy	Thing
Ithaca	Thing
J	definite_quantity_n1
Jamaica	Thing
Jamaican	person_n1
Jan	period_n1
January	period_n1
Javan	person_n1
Jordan	Thing
July	period_n1
June	period_n1
Kansas	location_n1
Kazakhstan	Thing
Kent	Thing
Kentucky	location_n1
Kenya	location_n1
Kiribati	Thing
Korean	person_n1
Kuwait	Thing
Kyrgyzstan	Thing
Lancashire	Thing
Latin	Thing
Latvia	Thing
Laurasia	Thing
Lebanon	Thing
Leicestershire	Thing
Leo	person_n1
Lesotho	Thing
Liberia	location_n1
Liberian	person_n1
Libya	Thing
Libyan	person_n1
Liechtenstein	Thing
Lincoln	Thing
Lincolnshire	Thing
Lithuania	Thing
Logan	Thing
Louisiana	location_n1
Lubbock	Thing
Luxembourg	Thing
M2	Thing
M3	Thing
Macau	Thing
Macedonia	Thing
Madagascar	location_n1
Madison	Thing
Maine	location_n1
Malawi	Thing
Malay	person_n1
Malayan	person_n1
Malaysia	location_n1
Mali	location_n1
Malta	Thing
Manitoba	Thing
Martinique	Thing
Maryland	location_n1
Massachusetts	location_n1
Mauritania	Thing
Mauritius	Thing
Mediterranean	Thing
Mexican	person_n1
Mexico	location_n1
Michigan	location_n1
Minnesota	location_n1
Mississippi	Thing
Missouri	location_n1
Mohave	person_n1
Mojave	person_n1
Moldova	Thing
Mon	period_n1
Monaco	Thing
Monday	period_n1
Mongolia	Thing
Mongolian	person_n1
Monroe	Thing
Montana	location_n1
Montenegro	Thing
Mozambique	Thing
Namibia	location_n1
Nancy	Thing
Nassau	Thing
Nauru	Thing
Nebraska	location_n1
Nepal	location_n1
Netherlands	Thing
Nevada	Thing
Nicaragua	Thing
Niger	Thing
Nigeria	Thing
Norfolk	location_n1
Norman	Thing
Northumberland	Thing
Norway	Thing
Norwegian	person_n1
November	period_n1
Nunavut	Thing
O	substance_n1
Oaxaca	Thing
October	period_n1
Ogden	Thing
Ohio	Thing
Oklahoma	location_n1
Oman	location_n1
Ontario	water_n2
Oregon	Thing
P	element_n2
Pakistan	Thing
Palestine	Thing
Panama	location_n1
Panamanian	person_n1
Pangaea	Thing
Papuan	Thing
Paraguay	Thing
Paraguayan	person_n1
Pennsylvania	location_n1
Persian	person_n1
Peru	location_n1
Peruvian	person_n1
Philippine	Thing
Philippines	Thing
Pierre	Thing
Poland	Thing
Portugal	Thing
Princeton	Thing
Puebla	Thing
Q	Thing
Qatar	Thing
Quebec	location_n1
Rio	Thing
Romania	Thing
Russia	location_n1
Rutland	Thing
Rwanda	location_n1
Saharan	Thing
Salvador	Thing
Samoa	Thing
Saskatchewan	Thing
Saudi	person_n1
Schenectady	Thing
Scotland	location_n1
Seattle	Thing
Senegal	Thing
September	period_n1
Serbia	Thing
Siberian	person_n1
Sichuan	Thing
Singapore	Thing
Sion	Thing
Slovakia	Thing
Slovenia	Thing
Somali	person_n1
Somalia	Thing
Somerset	Thing
Spain	location_n1
Spanish	Thing
Sudan	location_n1
Sumatran	person_n1
Sur	Thing
Suriname	Thing
Sussex	Thing
Swaziland	Thing
Sweden	Thing
Swiss	Thing
Switzerland	Thing
Syracuse	Thing
Syria	Thing
Tajikistan	Thing
Tanzania	location_n1
Tennessee	location_n1
Texas	location_n1
Thailand	location_n1
Thursday	period_n1
Tianjin	Thing
Tibet	Thing
Tibetan	person_n1
Togo	Thing
Tonga	Thing
Tucson	Thing
Tuesday	period_n1
Tunisia	Thing
Turkmenistan	Thing
Tuvalu	Thing
Uganda	location_n1
Ukraine	Thing
Uruguay	Thing
Utah	location_n1
Uzbekistan	Thing
Vancouver	Thing
Vanuatu	Thing
Venezuela	Thing
Veracruz	Thing
Vermont	location_n1
Vienna	Thing
Vietnam	location_n1
Vietnamese	person_n1
Virginia	location_n1
Washington	location_n1
Wednesday	period_n1
Wilson	Thing
Wisconsin	location_n1
Wyoming	location_n1
Xinjiang	Thing
Yemen	Thing
Yorkshire	Thing
Yukon	water_n2
Yuma	person_n1
Yunnan	Thing
Z	event_n1
Zambia	Thing
Zimbabwe	Thing
aardvark	animal_n1
aardwolf	animal_n1
abbey	building_n1
abdomen	body_part_n1
ability	quality_n1
abnormality	state_n4
abrasion	phenomenon_n1
absence	state_n4
absorption	phenomenon_n1
abstinence	Thing
abstraction	knowledge_n1
abundance	property_n3
acacia	plant_n2
academy	social_group_n1
acceleration	property_n3
accelerator	artifact_n1
accelerometer	measuring_instrument_n1
accent	auditory_communication_n1
acceptance	knowledge_n1
acceptor	material_n1
accessory	Thing
accident	event_n1
accomplishment	action_n1
accordance	event_n1
accordion	device_n1
account	Thing
accumulation	phenomenon_n1
accuracy	quality_n1
acetyl	Thing
acetylene	material_n1
achievement	action_n1
acid	material_n1
acidity	property_n3
acknowledgement	state_n4
acknowledgment	message_n2
acne	illness_n1
acorn	plant_part_n1
acre	definite_quantity_n1
acrobat	person_n1
acrosome	body_part_n1
actin	material_n1
action	action_n1
activation	phenomenon_n1
activator	substance_n1
activity	activity_n1
actor	person_n1
actress	person_n1
actuality	state_n4
ad	message_n2
addax	animal_n1
adder	animal_n1
addiction	state_n4
addition	action_n1
additive	Thing
address	location_n1
adenine	material_n1
adenosine	material_n1
adenovirus	microorganism_n1
adhesive	material_n1
adjective	Thing
adjustment	event_n1
administration	period_n1
administrator	person_n1
admiral	person_n1
admiration	feeling_n1
admission	action_n1
adolescence	period_n1
adrenaline	material_n1
adult	person_n1
adulthood	period_n1
advancement	message_n2
advantage	quality_n1
advection	Thing
adventure	activity_n1
adverb	Thing
advert	message_n2
advertisement	message_n2
advice	message_n2
aeration	phenomenon_n1
aerial	device_n1
aeroplane	transport_n1
aerosol	phenomenon_n1
affair	state_n4
affect	feeling_n1
affection	feeling_n1
affirmation	message_n2
afghan	artifact_n1
afternoon	period_n1
age	property_n3
agency	social_group_n1
agent	Thing
aggregate	Thing
aggregation	Thing
aggression	Thing
aggressiveness	Thing
agouti	animal_n1
agreement	message_n2
agriculture	event_n1
agua	animal_n1
ailment	state_n4
aim	knowledge_n1
air	substance_n1
aircraft	transport_n1
airplane	transport_n1
airport	artifact_n1
airway	body_part_n1
alanine	material_n1
alarm	measuring_instrument_n1
albatross	bird_n1
albinism	state_n4
albino	person_n1
album	artifact_n1
albumen	material_n1
alcohol	food_n1
alder	material_n1
alga	microorganism_n1
algae	microorganism_n1
alien	person_n1
alkali	material_n1
alkalinity	property_n3
allele	Thing
allergen	substance_n1
allergy	state_n4
alley	artifact_n1
alligator	animal_n1
allotment	Thing
alloy	substance_n1
ally	social_group_n1
almanac	artifact_n1
almond	plant_part_n1
aloe	plant_n2
alp	formation_n5
alphabet	written_language_n1
alsatian	animal_n1
alteration	event_n1
alternation	quality_n1
alternative	process_n2
altimeter	measuring_instrument_n1
altitude	Thing
altocumulus	phenomenon_n1
altostratus	phenomenon_n1
aluminate	material_n1
aluminium	element_n2
aluminum	element_n2
alveolus	body_part_n1
amateur	person_n1
amazement	feeling_n1
ambition	feeling_n1
ambrosia	substance_n1
ambulance	transport_n1
ammonium	material_n1
ammunition	artifact_n1
amniocentesis	activity_n1
amoeba	microorganism_n1
amount	property_n3
amp	definite_quantity_n1
ampere	definite_quantity_n1
amphibian	animal_n1
amusement	feeling_n1
amylase	material_n1
analogy	process_n2
analysis	activity_n1
ananas	plant_part_n1
anaphase	period_n1
anaphylaxis	state_n4
anatomy	knowledge_n1
ancestor	person_n1
ancestry	social_group_n1
anchor	device_n1
anemia	state_n4
anemometer	measuring_instrument_n1
anemone	animal_n1
anesthetic	Thing
angel	knowledge_n1
anger	feeling_n1
angiosperm	plant_n2
angle	shape_n2
angler	fish_n1
anglerfish	fish_n1
angleworm	animal_n1
angwantibo	animal_n1
animal	animal_n1
animalcule	organism_n1
animation	activity_n1
ankle	body_part_n1
anniversary	period_n1
announcement	message_n2
annoyance	state_n4
anoa	animal_n1
anode	device_n1
anole	animal_n1
anorak	clothing_n1
anorexia	state_n4
answer	message_n2
ant	insect_n1
antacid	Thing
anteater	animal_n1
antelope	animal_n1
antenna	device_n1
anthem	auditory_communication_n1
anther	plant_part_n1
antheridium	plant_part_n1
anthology	artifact_n1
anthrax	illness_n1
antibiotic	Thing
antibody	material_n1
anticipation	feeling_n1
antidiuretic	Thing
antidote	Thing
antifreeze	substance_n1
antigen	substance_n1
antihistamine	Thing
antivenin	material_n1
antler	body_part_n1
anus	body_part_n1
anxiety	state_n4
anything	Thing
aorta	body_part_n1
aoudad	animal_n1
apartment	artifact_n1
apatite	material_n1
ape	animal_n1
aperture	device_n1
aphelion	location_n1
aphid	insect_n1
apparatus	equipment_n1
appearance	quality_n1
appendage	body_part_n1
appendix	body_part_n1
appetite	feeling_n1
applause	message_n2
apple	plant_part_n1
appliance	device_n1
application	activity_n1
appreciation	process_n2
approach	activity_n1
appropriateness	Thing
approval	activity_n1
apricot	plant_n2
apron	clothing_n1
aptitude	knowledge_n1
aquarium	artifact_n1
aquifer	formation_n5
arc	shape_n2
arcade	artifact_n1
arch	shape_n2
archaebacteria	microorganism_n1
archaeologist	person_n1
archegonium	plant_part_n1
archer	person_n1
archery	activity_n1
architecture	building_n1
ardour	feeling_n1
area	property_n3
argali	animal_n1
argentine	fish_n1
argon	element_n2
argument	Thing
arithmetic	knowledge_n1
ark	transport_n1
arm	body_part_n1
armadillo	animal_n1
armament	artifact_n1
armchair	artifact_n1
armor	artifact_n1
armour	Thing
army	social_group_n1
aroma	property_n3
arrangement	process_n2
array	Thing
arrival	action_n1
arrow	device_n1
arse	body_part_n1
arsenic	element_n2
art	artifact_n1
artery	body_part_n1
arthritis	illness_n1
arthropod	animal_n1
article	artifact_n1
artifact	artifact_n1
artist	person_n1
artiste	person_n1
artwork	Thing
ash	substance_n1
asp	animal_n1
asparagine	material_n1
asparagus	plant_n2
aspect	knowledge_n1
aspen	plant_n2
asphalt	artifact_n1
aspiration	Thing
aspirin	material_n1
ass	animal_n1
assembly	device_n1
assessment	process_n2
asset	quality_n1
assignment	activity_n1
assistance	activity_n1
assistant	person_n1
association	Thing
assortment	Thing
assumption	message_n2
asteroid	heavenly_body_n1
asthenosphere	location_n1
asthma	illness_n1
astonishment	feeling_n1
astronaut	person_n1
astronomer	person_n1
astronomy	knowledge_n1
asymmetry	property_n3
atherosclerosis	state_n4
athlete	person_n1
atlas	artifact_n1
atmosphere	location_n1
atom	substance_n1
atrium	body_part_n1
attachment	action_n1
attack	activity_n1
attacker	person_n1
attempt	activity_n1
attendant	person_n1
attention	process_n2
attenuation	event_n1
attic	artifact_n1
attitude	knowledge_n1
attraction	phenomenon_n1
attribute	knowledge_n1
attribution	process_n2
auctioneer	person_n1
audience	social_group_n1
audio	auditory_communication_n1
audition	knowledge_n1
auditorium	artifact_n1
aunt	person_n1
auntie	person_n1
author	person_n1
authority	quality_n1
autism	knowledge_n1
auto	transport_n1
automaton	person_n1
automobile	transport_n1
autosome	Thing
autotroph	plant_n2
autumn	period_n1
auxin	material_n1
availability	quality_n1
avalanche	event_n1
aversion	feeling_n1
avocado	plant_part_n1
award	Thing
awareness	process_n2
ax	tool_n1
axe	tool_n1
axil	shape_n2
axis	location_n1
axle	artifact_n1
axon	material_n1
baa	sound_n4
babirusa	animal_n1
baboon	animal_n1
baby	person_n1
baby-sitter	person_n1
back	body_part_n1
backbone	body_part_n1
backflow	event_n1
background	knowledge_n1
backhoe	device_n1
backpack	artifact_n1
backstage	artifact_n1
backup	phenomenon_n1
backwoods	location_n1
backwoodsman	person_n1
backyard	location_n1
bacon	substance_n1
bacterium	microorganism_n1
badge	process_n2
badger	animal_n1
badminton	activity_n1
badness	quality_n1
bag	artifact_n1
baggage	artifact_n1
bait	knowledge_n1
baker	person_n1
bakery	location_n1
balaclava	clothing_n1
balance	measuring_instrument_n1
baldness	state_n4
bale	artifact_n1
baleen	material_n1
ball	equipment_n1
ballad	auditory_communication_n1
ballet	activity_n1
balloon	artifact_n1
ballot	written_language_n1
ballroom	artifact_n1
balsa	material_n1
bamboo	material_n1
banana	plant_n2
band	artifact_n1
bandage	artifact_n1
bandicoot	animal_n1
bandsaw	tool_n1
bandstand	artifact_n1
bang	event_n1
bangle	artifact_n1
banjo	device_n1
bank	formation_n5
banner	artifact_n1
banteng	animal_n1
baobab	plant_n2
bar	artifact_n1
barb	material_n1
barbeque	food_n1
barber	person_n1
barite	material_n1
bark	sound_n4
barker	person_n1
barley	food_n1
barman	person_n1
barn	building_n1
barnacle	animal_n1
barometer	measuring_instrument_n1
baron	person_n1
barrack	artifact_n1
barrel	shape_n2
barrier	artifact_n1
barrow	artifact_n1
basalt	material_n1
base	artifact_n1
baseball	activity_n1
basement	artifact_n1
bash	event_n1
basidiocarp	plant_part_n1
basil	plant_n2
basilisk	knowledge_n1
basin	artifact_n1
basis	Thing
basket	artifact_n1
basketball	activity_n1
basketful	indefinite_quantity_n1
bass	substance_n1
bast	material_n1
bat	animal_n1
batch	Thing
bath	artifact_n1
bathroom	artifact_n1
battery	device_n1
battle	event_n1
battlement	artifact_n1
bay	water_n2
bazaar	artifact_n1
beach	formation_n5
beacon	Thing
bead	artifact_n1
beagle	animal_n1
beak	body_part_n1
beaker	artifact_n1
beam	phenomenon_n1
bean	substance_n1
beanstalk	plant_part_n1
bear	animal_n1
beard	Thing
bearing	property_n3
bearskin	material_n1
beast	animal_n1
beauty	quality_n1
beaver	animal_n1
bed	artifact_n1
bedclothes	artifact_n1
bedrock	Thing
bedroom	artifact_n1
bedside	location_n1
bedtime	knowledge_n1
bee	insect_n1
beech	plant_n2
beef	substance_n1
beefeater	person_n1
beehive	Thing
beer	food_n1
beet	plant_n2
beetle	insect_n1
beetroot	plant_n2
beggar	person_n1
beginning	event_n1
behavior	activity_n1
behaviour	state_n4
being	state_n4
belfry	artifact_n1
belief	knowledge_n1
bell	device_n1
belladonna	plant_n2
belle	person_n1
belly	body_part_n1
belt	clothing_n1
beluga	fish_n1
bench	artifact_n1
benchmark	Thing
benefit	quality_n1
benzene	material_n1
beret	clothing_n1
berry	plant_part_n1
beryllium	element_n2
bet	Thing
beta	Thing
beth	Thing
bettong	animal_n1
beverage	food_n1
bias	knowledge_n1
bib	artifact_n1
bibliotheca	Thing
bicarbonate	material_n1
biceps	body_part_n1
bicycle	transport_n1
bighorn	animal_n1
bike	transport_n1
bilby	animal_n1
bile	substance_n1
bill	written_language_n1
bin	artifact_n1
binoculars	device_n1
binomial	knowledge_n1
binturong	animal_n1
biochemistry	knowledge_n1
biodiversity	quality_n1
biogeography	knowledge_n1
biologist	person_n1
biology	knowledge_n1
biomass	substance_n1
biome	biome_n1
biosphere	location_n1
biosynthesis	phenomenon_n1
biotechnology	knowledge_n1
bioterrorism	event_n1
birch	material_n1
bird	bird_n1
birdbath	artifact_n1
birth	Thing
birthday	period_n1
birthplace	location_n1
biscuit	substance_n1
bison	animal_n1
bit	indefinite_quantity_n1
bitterness	property_n3
bivalve	animal_n1
blackberry	plant_part_n1
blackbird	bird_n1
blackboard	artifact_n1
blackbuck	animal_n1
blacksmith	person_n1
blacktop	artifact_n1
blackwood	material_n1
blade	device_n1
blanket	artifact_n1
blast	sound_n4
blastocyst	animal_n1
bleach	Thing
bleat	sound_n4
blend	event_n1
blender	artifact_n1
blighter	person_n1
blindfold	artifact_n1
blindness	state_n4
bliss	state_n4
blister	body_part_n1
blizzard	phenomenon_n1
blob	shape_n2
block	artifact_n1
blockage	state_n4
blog	written_language_n1
bloke	person_n1
blonde	person_n1
blood	substance_n1
bloodroot	plant_n2
bloodstream	substance_n1
bloodwort	plant_n2
blossom	plant_part_n1
blot	quality_n1
blotch	quality_n1
blouse	clothing_n1
blow	action_n1
blowfly	insect_n1
blubber	material_n1
bluebell	plant_n2
blueberry	plant_part_n1
bluebird	bird_n1
bluebottle	plant_n2
bluefin	substance_n1
bluefish	fish_n1
bluff	formation_n5
blunder	event_n1
boa	animal_n1
boar	animal_n1
board	artifact_n1
boat	transport_n1
boatman	person_n1
bobby	person_n1
bobcat	animal_n1
body	Thing
bog	Thing
boiler	artifact_n1
bole	material_n1
bomb	device_n1
bonanza	formation_n5
bond	phenomenon_n1
bone	body_part_n1
bonfire	event_n1
bongo	device_n1
bonnet	clothing_n1
bonobo	animal_n1
booby	bird_n1
boogie	auditory_communication_n1
book	artifact_n1
bookcase	artifact_n1
bookend	device_n1
booklet	artifact_n1
boomerang	device_n1
booster	Thing
boot	artifact_n1
booth	artifact_n1
booty	Thing
borax	material_n1
bore	event_n1
boron	element_n2
boss	person_n1
botanist	person_n1
botany	knowledge_n1
bother	activity_n1
bottle	artifact_n1
bottleneck	property_n3
bottlenose	animal_n1
bottom	location_n1
boulder	Thing
boundary	location_n1
bowel	body_part_n1
bowerbird	bird_n1
bowhead	animal_n1
bowl	artifact_n1
bowler	person_n1
bowman	person_n1
box	artifact_n1
boxer	person_n1
boy	person_n1
boyfriend	person_n1
brace	device_n1
bracelet	artifact_n1
brachiation	action_n1
brain	body_part_n1
brainstem	body_part_n1
brainwave	phenomenon_n1
brake	device_n1
bramble	plant_n2
branch	social_group_n1
brand	Thing
brandy	food_n1
brant	bird_n1
brass	substance_n1
bravery	Thing
bravo	message_n2
brazil	plant_part_n1
bread	substance_n1
breadcrumb	indefinite_quantity_n1
breadth	knowledge_n1
break	event_n1
breakage	indefinite_quantity_n1
breakdown	action_n1
breakfast	food_n1
breakthrough	process_n2
breast	body_part_n1
breath	phenomenon_n1
breed	social_group_n1
breeder	person_n1
breeze	phenomenon_n1
bribery	activity_n1
brick	artifact_n1
bricklayer	person_n1
bride	person_n1
bridegroom	person_n1
bridesmaid	person_n1
bridge	device_n1
bridle	equipment_n1
brigade	social_group_n1
brightness	property_n3
brim	artifact_n1
bristle	material_n1
broadcast	Thing
broccoli	plant_n2
brocket	animal_n1
brolly	artifact_n1
bromine	element_n2
bronchiole	body_part_n1
bronchus	body_part_n1
bronze	substance_n1
brood	Thing
brook	water_n2
broom	artifact_n1
broomstick	Thing
broth	food_n1
brother	person_n1
brow	body_part_n1
brownie	Thing
bruise	state_n4
bruiser	person_n1
brunch	food_n1
brush	Thing
bryophyte	organism_n1
bubble	shape_n2
buck	animal_n1
bucket	artifact_n1
buckle	device_n1
bud	plant_part_n1
budgerigar	bird_n1
budget	Thing
budgie	bird_n1
buff	person_n1
buffalo	animal_n1
buffoon	person_n1
bufo	animal_n1
bug	insect_n1
buggy	transport_n1
builder	person_n1
building	building_n1
buildup	action_n1
bulb	device_n1
bulimia	state_n4
bulk	property_n3
bull	animal_n1
bulldog	animal_n1
bulldozer	transport_n1
bullet	device_n1
bulletin	message_n2
bullfrog	animal_n1
bullock	animal_n1
bully	person_n1
bum	person_n1
bumper	device_n1
bun	substance_n1
bunch	Thing
bundle	Thing
bungalow	building_n1
bunion	knowledge_n1
bunk	artifact_n1
bunny	animal_n1
bunsen	equipment_n1
buoyancy	property_n3
burden	knowledge_n1
burdock	plant_n2
bureau	social_group_n1
burgess	person_n1
burglar	person_n1
burglary	activity_n1
burial	event_n1
burn	state_n4
burner	equipment_n1
burr	Thing
burrow	formation_n5
bus	transport_n1
bush	plant_n2
bushbaby	animal_n1
bushbuck	animal_n1
bushman	person_n1
business	social_group_n1
businessman	person_n1
butler	person_n1
butt	body_part_n1
butter	food_n1
buttercup	plant_n2
butterfly	insect_n1
button	device_n1
buzzer	device_n1
bye	message_n2
bye-bye	message_n2
byproduct	phenomenon_n1
bystander	person_n1
c	definite_quantity_n1
cab	artifact_n1
cabbage	substance_n1
cabin	artifact_n1
cabinet	artifact_n1
cable	device_n1
cacomistle	animal_n1
cactus	plant_n2
cadmium	element_n2
caecum	body_part_n1
cafe	building_n1
caffeine	material_n1
cage	artifact_n1
caiman	animal_n1
cake	substance_n1
calcite	material_n1
calcitonin	substance_n1
calcium	element_n2
calculation	activity_n1
calculator	device_n1
calendar	knowledge_n1
calf	animal_n1
caliper	measuring_instrument_n1
call	artifact_n1
calorie	definite_quantity_n1
calorimeter	measuring_instrument_n1
cam	device_n1
camel	animal_n1
camera	equipment_n1
camp	artifact_n1
campaign	event_n1
camper	person_n1
campfire	event_n1
campsite	location_n1
can	artifact_n1
canal	body_part_n1
canary	bird_n1
cancer	illness_n1
candida	plant_n2
candidate	person_n1
candidiasis	phenomenon_n1
candle	device_n1
candlestick	device_n1
candy	food_n1
cane	artifact_n1
cannon	artifact_n1
cannonball	device_n1
canoe	transport_n1
canon	message_n2
cantaloup	plant_n2
cantaloupe	plant_n2
canteen	artifact_n1
canvas	artifact_n1
canvasback	bird_n1
canyon	formation_n5
cap	clothing_n1
capability	quality_n1
capacity	quality_n1
cape	clothing_n1
capillary	artifact_n1
capital	location_n1
capsid	insect_n1
capsule	artifact_n1
captain	person_n1
captive	person_n1
capuchin	animal_n1
capybara	animal_n1
car	transport_n1
carabao	animal_n1
caracal	animal_n1
carapace	body_part_n1
caravan	event_n1
carbide	material_n1
carbohydrate	material_n1
carbon	element_n2
carcinogen	substance_n1
card	material_n1
cardamom	plant_n2
cardboard	material_n1
cardigan	clothing_n1
cardinal	bird_n1
care	activity_n1
career	activity_n1
caretaker	person_n1
cargo	artifact_n1
caribou	animal_n1
carnation	plant_n2
carnival	activity_n1
carnivore	animal_n1
carol	activity_n1
carp	fish_n1
carpel	plant_part_n1
carpenter	person_n1
carpet	artifact_n1
carriage	transport_n1
carrier	person_n1
carrot	plant_part_n1
cart	transport_n1
carter	person_n1
cartilage	body_part_n1
carton	artifact_n1
cartoon	message_n2
cartwheel	action_n1
case	artifact_n1
cash	Thing
cashew	plant_part_n1
cassowary	bird_n1
caster	person_n1
casting	artifact_n1
castle	building_n1
casualty	person_n1
cat	animal_n1
catalog	artifact_n1
catalysis	Thing
cataract	illness_n1
catcher	person_n1
category	Thing
caterpillar	animal_n1
catfish	substance_n1
cathedral	building_n1
catheter	artifact_n1
catkin	plant_part_n1
cattail	plant_n2
cattle	animal_n1
cauldron	artifact_n1
cause	event_n1
causeway	artifact_n1
cave	formation_n5
cavern	shape_n2
cavity	phenomenon_n1
cavy	animal_n1
cayenne	plant_n2
cayman	animal_n1
cc	definite_quantity_n1
cecum	body_part_n1
cedar	plant_n2
ceiling	artifact_n1
celebration	event_n1
celery	plant_n2
cell	Thing
cellar	artifact_n1
cellophane	artifact_n1
cellphone	equipment_n1
cellulose	material_n1
census	activity_n1
cent	definite_quantity_n1
center	location_n1
centiliter	definite_quantity_n1
centimeter	definite_quantity_n1
centimetre	definite_quantity_n1
centipede	animal_n1
centre	location_n1
centriole	body_part_n1
centromere	body_part_n1
century	period_n1
cereal	plant_n2
cerebellum	body_part_n1
cerebrum	body_part_n1
ceremony	event_n1
certainty	state_n4
certificate	written_language_n1
cervix	body_part_n1
cessation	event_n1
chad	material_n1
chaffinch	bird_n1
chain	Thing
chainsaw	tool_n1
chair	artifact_n1
chalk	artifact_n1
challenge	event_n1
chamber	artifact_n1
chamberlain	person_n1
chameleon	animal_n1
chamois	material_n1
champ	person_n1
champagne	food_n1
champion	person_n1
chance	state_n4
chancellor	person_n1
chandler	person_n1
channel	artifact_n1
chaos	state_n4
chap	person_n1
chaparral	biome_n1
chapter	auditory_communication_n1
character	knowledge_n1
characteristic	knowledge_n1
charcoal	element_n2
charge	phenomenon_n1
chariot	transport_n1
charisma	quality_n1
charity	social_group_n1
charm	quality_n1
chart	Thing
chatter	auditory_communication_n1
checkerboard	artifact_n1
checklist	message_n2
checkpoint	location_n1
cheek	body_part_n1
cheer	message_n2
cheese	food_n1
cheetah	animal_n1
chef	person_n1
chelicera	body_part_n1
chemical	material_n1
chemist	person_n1
chemistry	knowledge_n1
chemosynthesis	phenomenon_n1
chemotherapy	activity_n1
chequebook	Thing
cherry	plant_part_n1
chess	activity_n1
chest	body_part_n1
chestnut	plant_part_n1
chevrotain	animal_n1
chi	state_n4
chick	bird_n1
chicken	bird_n1
chicot	plant_n2
chief	person_n1
child	person_n1
childbirth	phenomenon_n1
childhood	period_n1
chile	substance_n1
chill	property_n3
chimera	process_n2
chimney	artifact_n1
chimp	animal_n1
chimpanzee	animal_n1
chin	body_part_n1
china	artifact_n1
chinchilla	animal_n1
chipmunk	animal_n1
chisel	tool_n1
chitin	material_n1
chlamydia	illness_n1
chloride	material_n1
chlorine	element_n2
chlorophyl	material_n1
chlorophyll	material_n1
chloroplast	material_n1
choanocyte	Thing
chocolate	substance_n1
choice	process_n2
choir	social_group_n1
choker	artifact_n1
cholera	illness_n1
cholesterol	material_n1
chomp	Thing
chopper	transport_n1
chore	activity_n1
chorus	social_group_n1
chou	Thing
chough	bird_n1
chromate	material_n1
chromatid	material_n1
chromatin	substance_n1
chromite	material_n1
chromium	element_n2
chromoplast	material_n1
chromosome	Thing
chrysalis	insect_n1
chum	person_n1
chunk	Thing
church	building_n1
churchyard	location_n1
cicada	insect_n1
cider	food_n1
cigar	material_n1
cigarette	material_n1
ciliate	microorganism_n1
cilium	body_part_n1
cinder	Thing
cinema	artifact_n1
cinnamon	Thing
circle	shape_n2
circuit	device_n1
circulation	event_n1
circumference	property_n3
circumstance	state_n4
circus	social_group_n1
cirrhosis	illness_n1
cirrocumulus	phenomenon_n1
cirrostratus	phenomenon_n1
cirrus	phenomenon_n1
cistern	body_part_n1
citation	Thing
citizen	person_n1
citrus	substance_n1
city	location_n1
civet	animal_n1
civilisation	social_group_n1
civilization	social_group_n1
cl	definite_quantity_n1
clade	Thing
cladogram	shape_n2
clam	animal_n1
clamp	device_n1
clank	sound_n4
clapper	body_part_n1
clarification	message_n2
clarinet	device_n1
clarity	quality_n1
clash	sound_n4
class	Thing
classification	activity_n1
classmate	person_n1
classroom	artifact_n1
claw	body_part_n1
clay	material_n1
cleaner	material_n1
cleanliness	Thing
clearance	Thing
cleavage	state_n4
cleft	shape_n2
cleverness	knowledge_n1
cliff	formation_n5
climate	state_n4
climatology	knowledge_n1
climber	plant_n2
clinic	social_group_n1
clipboard	artifact_n1
clipper	device_n1
clipping	auditory_communication_n1
cloaca	artifact_n1
cloak	artifact_n1
cloakroom	artifact_n1
clock	measuring_instrument_n1
clockwork	device_n1
closet	artifact_n1
cloth	artifact_n1
clothes	clothing_n1
clothesline	artifact_n1
clothing	clothing_n1
cloud	phenomenon_n1
clover	plant_n2
clown	person_n1
club	social_group_n1
cluck	sound_n4
clue	Thing
clump	Thing
cluster	Thing
cm	definite_quantity_n1
cnidarian	animal_n1
coach	person_n1
coal	substance_n1
coast	formation_n5
coaster	artifact_n1
coastline	location_n1
coat	clothing_n1
coati	animal_n1
coating	artifact_n1
cob	plant_part_n1
cobalt	element_n2
cobra	animal_n1
cobweb	material_n1
cocaine	Thing
cochlea	body_part_n1
cock-a-doodle-doo	sound_n4
cockatiel	bird_n1
cockatoo	bird_n1
cockerel	bird_n1
cocklebur	plant_n2
cockroach	insect_n1
coco	plant_n2
cocoa	food_n1
coconut	substance_n1
cocoon	Thing
cod	fish_n1
code	written_language_n1
codfish	Thing
codon	Thing
coelacanth	fish_n1
coelenteron	body_part_n1
coelom	body_part_n1
coenzyme	Thing
coffee	food_n1
coffin	artifact_n1
cognition	knowledge_n1
coho	substance_n1
coin	Thing
coinage	Thing
coincidence	event_n1
cola	food_n1
coldness	process_n2
cole	plant_n2
collagen	material_n1
collar	artifact_n1
collection	Thing
collector	person_n1
college	social_group_n1
collision	event_n1
colloid	substance_n1
colobus	animal_n1
colon	body_part_n1
colonization	action_n1
colony	social_group_n1
color	property_n3
coloration	property_n3
colugo	animal_n1
columbite	material_n1
column	Thing
coma	state_n4
comb	device_n1
combat	event_n1
combination	Thing
combustion	phenomenon_n1
comet	Thing
comfort	state_n4
command	event_n1
commensalism	Thing
commerce	event_n1
commission	social_group_n1
commissioner	person_n1
commitment	Thing
committee	social_group_n1
commodity	artifact_n1
commonality	quality_n1
commotion	state_n4
communication	event_n1
community	social_group_n1
commutator	device_n1
commuter	person_n1
compaction	event_n1
compactness	Thing
companion	person_n1
companionship	state_n4
company	social_group_n1
comparison	activity_n1
compartment	artifact_n1
compass	device_n1
competition	Thing
complement	knowledge_n1
completion	action_n1
complexity	quality_n1
compliance	event_n1
compliment	message_n2
component	knowledge_n1
composite	knowledge_n1
composition	artifact_n1
compost	substance_n1
compound	material_n1
comprehension	process_n2
compression	event_n1
compromise	event_n1
compulsion	Thing
computation	activity_n1
computer	device_n1
concentration	property_n3
concept	knowledge_n1
conception	phenomenon_n1
concern	state_n4
concert	event_n1
concession	written_language_n1
conclusion	knowledge_n1
concrete	artifact_n1
condensation	phenomenon_n1
condition	state_n4
conditioner	activity_n1
condom	device_n1
conductance	phenomenon_n1
conduction	phenomenon_n1
conductivity	phenomenon_n1
conductor	material_n1
conduit	artifact_n1
cone	artifact_n1
coney	fish_n1
conference	social_group_n1
confetti	material_n1
confidence	state_n4
confinement	activity_n1
conflict	event_n1
conformity	quality_n1
confusion	state_n4
conger	fish_n1
congestion	knowledge_n1
congratulation	event_n1
conifer	plant_n2
conjunction	property_n3
conjuror	person_n1
conker	plant_part_n1
connection	Thing
connotation	message_n2
consensus	state_n4
consent	message_n2
consequence	phenomenon_n1
conservation	event_n1
consideration	process_n2
consortium	social_group_n1
constable	person_n1
constellation	Thing
constipation	knowledge_n1
constituent	Thing
constraint	state_n4
constriction	property_n3
constrictor	animal_n1
construction	activity_n1
consultant	person_n1
consumption	phenomenon_n1
contact	state_n4
container	artifact_n1
contamination	state_n4
content	Thing
contest	event_n1
context	state_n4
continent	Thing
contingent	social_group_n1
continuity	state_n4
continuum	Thing
contour	Thing
contract	written_language_n1
contraction	action_n1
contractor	person_n1
contribution	activity_n1
contributor	person_n1
controversy	event_n1
convection	phenomenon_n1
convenience	quality_n1
convent	building_n1
convention	social_group_n1
conversation	auditory_communication_n1
conversion	event_n1
conveyer	person_n1
conveyor	person_n1
cookbook	artifact_n1
cooker	artifact_n1
cookery	action_n1
cookie	substance_n1
coolant	substance_n1
coop	building_n1
cooperation	event_n1
coot	bird_n1
cop	person_n1
copper	element_n2
copula	Thing
copy	artifact_n1
coral	property_n3
cord	artifact_n1
cordgrass	plant_n2
core	location_n1
cork	material_n1
corkscrew	tool_n1
corn	plant_n2
cornea	body_part_n1
corner	location_n1
cornet	device_n1
corneum	location_n1
cornfield	location_n1
corona	phenomenon_n1
coronation	event_n1
corporation	social_group_n1
corpus	Thing
correlation	Thing
correspondence	written_language_n1
corrosion	state_n4
cortex	body_part_n1
corticosteroid	substance_n1
cortisol	substance_n1
cosine	Thing
cost	quality_n1
costa	body_part_n1
costume	clothing_n1
cot	artifact_n1
cottage	building_n1
cotton	material_n1
cottonmouth	animal_n1
cottontail	animal_n1
cotyledon	plant_part_n1
cougar	animal_n1
cough	knowledge_n1
council	social_group_n1
counsel	person_n1
counselor	person_n1
counter	artifact_n1
counterfeiter	person_n1
countertop	artifact_n1
country	location_n1
countryside	location_n1
county	location_n1
couple	indefinite_quantity_n1
courage	Thing
courgette	plant_n2
courier	person_n1
course	Thing
court	social_group_n1
courtesy	action_n1
courtier	person_n1
courtyard	location_n1
cousin	person_n1
cove	water_n2
coverage	property_n3
covering	Thing
cow	animal_n1
coward	person_n1
cowboy	person_n1
cowman	person_n1
cowshed	building_n1
cox	person_n1
coyote	animal_n1
crab	animal_n1
crack	location_n1
cracker	substance_n1
craft	transport_n1
crake	bird_n1
cranium	body_part_n1
cranny	shape_n2
crash	event_n1
crate	artifact_n1
crater	shape_n2
crayon	artifact_n1
cream	food_n1
creation	activity_n1
creativity	knowledge_n1
creature	animal_n1
credit	message_n2
creed	knowledge_n1
creek	water_n2
creep	event_n1
creeper	plant_n2
creepy-crawly	animal_n1
crescent	shape_n2
crest	location_n1
cretin	person_n1
crevasse	shape_n2
crevice	shape_n2
crew	social_group_n1
cricket	insect_n1
crime	activity_n1
criminal	person_n1
crisis	state_n4
criterion	Thing
criticism	message_n2
critter	animal_n1
croak	auditory_communication_n1
crockery	artifact_n1
crocodile	animal_n1
crocodilian	animal_n1
crocus	plant_n2
crook	person_n1
crop	event_n1
crowbar	artifact_n1
crowd	social_group_n1
crust	location_n1
crystal	substance_n1
crystallization	phenomenon_n1
cube	shape_n2
cuckoo	bird_n1
cucumber	plant_n2
cud	food_n1
cuff	artifact_n1
culprit	person_n1
culture	social_group_n1
cumulonimbus	phenomenon_n1
cumulus	phenomenon_n1
cunning	knowledge_n1
cup	artifact_n1
cupboard	artifact_n1
curb	activity_n1
curd	food_n1
curiosity	state_n4
currant	plant_part_n1
current	phenomenon_n1
curriculum	message_n2
curry	food_n1
cursor	device_n1
curtain	artifact_n1
curve	property_n3
cuscus	animal_n1
cushion	artifact_n1
custard	food_n1
custom	activity_n1
customer	person_n1
cuticle	location_n1
cutlass	device_n1
cutlery	tool_n1
cuttlefish	animal_n1
cyanobacteria	microorganism_n1
cycad	plant_n2
cycle	Thing
cyclist	person_n1
cyclone	phenomenon_n1
cygnet	bird_n1
cylinder	artifact_n1
cymbal	device_n1
cynicism	feeling_n1
cynodont	animal_n1
cyst	state_n4
cytokine	material_n1
cytokinesis	phenomenon_n1
cytoplasm	substance_n1
cytosine	material_n1
cytoskeleton	body_part_n1
cytosol	substance_n1
dad	person_n1
daddy	person_n1
daffodil	plant_n2
dairy	location_n1
daisy	plant_n2
dale	formation_n5
dam	artifact_n1
damage	event_n1
dance	artifact_n1
dancer	person_n1
dandelion	plant_n2
danger	state_n4
darkness	state_n4
darling	person_n1
dart	device_n1
dash	action_n1
dashboard	device_n1
dassie	animal_n1
data	Thing
database	message_n2
date	Thing
daughter	person_n1
dawn	knowledge_n1
day	Thing
daybreak	knowledge_n1
daydream	knowledge_n1
daylight	period_n1
daytime	period_n1
dearie	person_n1
death	event_n1
debate	auditory_communication_n1
debris	material_n1
debt	state_n4
decade	period_n1
decagram	definite_quantity_n1
decapod	animal_n1
decay	phenomenon_n1
decease	event_n1
deceased	person_n1
deceit	quality_n1
deception	message_n2
decision	knowledge_n1
deck	artifact_n1
decomposition	phenomenon_n1
decoration	artifact_n1
decoy	device_n1
deduction	process_n2
deer	animal_n1
default	process_n2
defect	state_n4
defence	social_group_n1
defender	person_n1
defense	activity_n1
deficiency	state_n4
deficit	property_n3
definition	message_n2
deflation	Thing
deforestation	action_n1
deformity	state_n4
degenerate	person_n1
degeneration	phenomenon_n1
degradation	action_n1
degree	property_n3
dehydration	state_n4
deinonychus	animal_n1
deletion	action_n1
delicacy	food_n1
delight	feeling_n1
delivery	action_n1
delta	formation_n5
deluge	phenomenon_n1
demography	knowledge_n1
demoiselle	person_n1
demolition	event_n1
demonstration	activity_n1
den	location_n1
dendrite	material_n1
denial	event_n1
denim	clothing_n1
density	property_n3
dentist	person_n1
dentistry	knowledge_n1
deoxyribose	material_n1
department	social_group_n1
departure	action_n1
dependence	state_n4
dependency	state_n4
depiction	message_n2
depletion	action_n1
deposition	phenomenon_n1
depression	state_n4
depth	property_n3
deputy	person_n1
dermis	location_n1
descendant	person_n1
descent	event_n1
description	message_n2
desert	location_n1
design	activity_n1
designation	Thing
designer	person_n1
desirability	quality_n1
desire	feeling_n1
desk	artifact_n1
despair	state_n4
desperation	state_n4
despite	feeling_n1
dessert	food_n1
destination	location_n1
destruction	action_n1
detail	knowledge_n1
detection	process_n2
detective	person_n1
detector	device_n1
deterioration	state_n4
determinant	knowledge_n1
determination	action_n1
deterrent	knowledge_n1
detritus	material_n1
developer	person_n1
development	phenomenon_n1
deviation	event_n1
device	measuring_instrument_n1
devil	knowledge_n1
dew	phenomenon_n1
dhole	animal_n1
diabetes	illness_n1
diagnosis	action_n1
diagram	artifact_n1
dialysis	activity_n1
diameter	property_n3
diamond	artifact_n1
diamondback	animal_n1
diaper	clothing_n1
diaphragm	body_part_n1
diarrhea	knowledge_n1
diarrhoea	knowledge_n1
diary	written_language_n1
diatom	microorganism_n1
dice	artifact_n1
dicotyledon	plant_n2
dictator	person_n1
dictionary	artifact_n1
diet	food_n1
difference	quality_n1
differentiation	process_n2
difficulty	activity_n1
diffraction	phenomenon_n1
diffusion	phenomenon_n1
digestion	phenomenon_n1
digger	person_n1
digit	definite_quantity_n1
dilation	event_n1
dill	plant_n2
dilution	substance_n1
dime	Thing
dimension	property_n3
dimetrodon	animal_n1
dimorphism	phenomenon_n1
din	sound_n4
diner	person_n1
dinghy	transport_n1
dingo	animal_n1
dinner	food_n1
dinoflagellate	microorganism_n1
dinosaur	animal_n1
diode	device_n1
diorite	material_n1
dioxide	material_n1
dipper	artifact_n1
direction	Thing
director	person_n1
dirk	device_n1
dirt	material_n1
disability	state_n4
disadvantage	quality_n1
disappearance	action_n1
disaster	state_n4
disbelief	state_n4
disc	device_n1
discharge	event_n1
disco	artifact_n1
discourse	Thing
discovery	action_n1
discrepancy	quality_n1
discussion	event_n1
disease	illness_n1
disguise	quality_n1
dish	artifact_n1
disharmony	property_n3
dishwasher	artifact_n1
disintegration	state_n4
disk	shape_n2
dismay	feeling_n1
disorder	state_n4
dispersal	action_n1
dispersion	event_n1
displacement	event_n1
disposal	quality_n1
disposition	Thing
disruption	event_n1
dissimilarity	quality_n1
distance	Thing
distaste	feeling_n1
distinction	process_n2
distress	feeling_n1
distribution	knowledge_n1
district	location_n1
disturbance	activity_n1
disuse	state_n4
ditch	artifact_n1
ditty	auditory_communication_n1
diver	person_n1
diversification	action_n1
diversion	activity_n1
diversity	quality_n1
division	action_n1
divorce	event_n1
dobson	animal_n1
doc	person_n1
doctor	person_n1
doctrine	knowledge_n1
document	written_language_n1
documentation	message_n2
doddle	activity_n1
dodo	bird_n1
dog	animal_n1
doggy	animal_n1
dogma	knowledge_n1
dole	Thing
doll	artifact_n1
dollar	definite_quantity_n1
dollop	indefinite_quantity_n1
dolly	transport_n1
dolphin	animal_n1
domain	state_n4
dome	shape_n2
domestication	phenomenon_n1
dominance	property_n3
domino	clothing_n1
donkey	process_n2
donut	substance_n1
door	artifact_n1
doorbell	device_n1
doorknob	Thing
doormat	person_n1
doorstep	device_n1
doorway	artifact_n1
dormancy	state_n4
dormouse	animal_n1
dose	Thing
dot	shape_n2
double-decker	transport_n1
doubloon	Thing
doubt	state_n4
dough	food_n1
doughnut	shape_n2
dove	bird_n1
downpour	phenomenon_n1
downside	knowledge_n1
dozen	definite_quantity_n1
dragonfly	insect_n1
drainage	action_n1
drainpipe	artifact_n1
drake	bird_n1
drama	written_language_n1
dramatization	activity_n1
draught	indefinite_quantity_n1
drawback	quality_n1
drawer	artifact_n1
drawing	Thing
dray	transport_n1
dream	process_n2
drink	indefinite_quantity_n1
driver	Thing
driveway	artifact_n1
drizzle	phenomenon_n1
drone	insect_n1
droplet	indefinite_quantity_n1
dropper	measuring_instrument_n1
drought	state_n4
drowsiness	state_n4
drug	Thing
drum	device_n1
drumlin	Thing
drummer	person_n1
dryer	artifact_n1
dryness	state_n4
duchess	person_n1
duck	bird_n1
duckling	substance_n1
duckweed	plant_n2
duct	body_part_n1
dud	event_n1
dugong	animal_n1
duke	person_n1
dullness	knowledge_n1
dumper	transport_n1
dumpling	substance_n1
dune	formation_n5
dung	material_n1
dungeon	artifact_n1
duodenum	body_part_n1
duplicate	artifact_n1
duplication	artifact_n1
durability	property_n3
duration	period_n1
dusk	knowledge_n1
dust	material_n1
dustbin	artifact_n1
duster	phenomenon_n1
dustman	person_n1
dustpan	indefinite_quantity_n1
duty	activity_n1
duvet	artifact_n1
dwarf	person_n1
dweller	person_n1
dye	material_n1
dynamo	device_n1
dyne	definite_quantity_n1
eagle	bird_n1
ear	body_part_n1
eardrum	body_part_n1
earlobe	body_part_n1
earphone	device_n1
earring	artifact_n1
earth	material_n1
earthenware	artifact_n1
earthquake	phenomenon_n1
earthworm	animal_n1
earwig	insect_n1
ease	quality_n1
eater	person_n1
echidna	animal_n1
echinoderm	animal_n1
echo	property_n3
echolocation	action_n1
eclipse	event_n1
ecologist	person_n1
ecology	state_n4
economics	knowledge_n1
economist	person_n1
economy	Thing
ecosystem	Thing
ectoderm	body_part_n1
ectotherm	animal_n1
edaphosaurus	animal_n1
edge	location_n1
editor	person_n1
education	activity_n1
educator	person_n1
eel	substance_n1
effect	phenomenon_n1
effectiveness	quality_n1
efficiency	Thing
effort	activity_n1
egg	Thing
eggshell	Thing
ejaculation	phenomenon_n1
el	social_group_n1
eland	animal_n1
elastic	artifact_n1
elbow	body_part_n1
eld	period_n1
elder	person_n1
electrician	person_n1
electricity	phenomenon_n1
electrolyte	substance_n1
electromagnet	device_n1
electron	Thing
electronics	knowledge_n1
element	element_n2
elephant	animal_n1
elevation	event_n1
elevator	device_n1
elf	knowledge_n1
elimination	action_n1
elk	animal_n1
ellipse	shape_n2
elm	plant_n2
elongation	property_n3
elucidation	event_n1
embarrassment	feeling_n1
ember	Thing
emblem	artifact_n1
embodiment	person_n1
embryo	plant_n2
embryology	knowledge_n1
emerald	material_n1
emergence	event_n1
emergency	event_n1
emigration	action_n1
emirate	location_n1
emission	action_n1
emotion	feeling_n1
emperor	insect_n1
emphasis	state_n4
emphysema	illness_n1
empire	location_n1
employee	person_n1
employment	state_n4
emu	definite_quantity_n1
emulsion	substance_n1
enamel	substance_n1
encyclopedia	artifact_n1
ending	Thing
endoderm	body_part_n1
endometrium	body_part_n1
endoskeleton	body_part_n1
endosperm	plant_part_n1
endospore	plant_part_n1
enemy	social_group_n1
energy	phenomenon_n1
engine	device_n1
engineer	person_n1
enhancer	knowledge_n1
enlargement	action_n1
enterprise	activity_n1
entertainer	person_n1
entertainment	activity_n1
enthusiasm	feeling_n1
entity	Thing
entomologist	person_n1
entomology	knowledge_n1
entrance	artifact_n1
entrepreneur	person_n1
entry	artifact_n1
envelope	artifact_n1
environment	location_n1
enzyme	material_n1
eon	Thing
epicenter	location_n1
epidemiology	knowledge_n1
epidermis	location_n1
epididymis	body_part_n1
epiglottis	body_part_n1
epilepsy	state_n4
epiphyte	plant_n2
episode	event_n1
epistasis	phenomenon_n1
epithelium	body_part_n1
epoch	period_n1
equation	message_n2
equator	location_n1
equilibrium	state_n4
equinox	Thing
equipment	equipment_n1
equivalent	knowledge_n1
era	period_n1
eraser	artifact_n1
erection	state_n4
erg	definite_quantity_n1
ermine	animal_n1
erosion	phenomenon_n1
errand	action_n1
error	event_n1
eruption	event_n1
erythrocyte	Thing
erythropoietin	material_n1
escalator	auditory_communication_n1
esophagus	body_part_n1
essay	written_language_n1
essence	knowledge_n1
establishment	action_n1
estate	Thing
esteem	state_n4
estimation	process_n2
estrogen	substance_n1
estuary	biome_n1
ethane	material_n1
ethanol	material_n1
ethic	knowledge_n1
ethologist	person_n1
ethology	knowledge_n1
eucalyptus	material_n1
euglenid	microorganism_n1
eukaryote	organism_n1
evaluation	event_n1
evaporation	phenomenon_n1
eve	Thing
evening	period_n1
event	event_n1
evergreen	plant_n2
evidence	knowledge_n1
evolution	phenomenon_n1
exactness	quality_n1
exam	event_n1
examination	activity_n1
example	knowledge_n1
excellence	quality_n1
exception	process_n2
excess	property_n3
exchange	phenomenon_n1
excitement	feeling_n1
exclusion	state_n4
excretion	phenomenon_n1
excuse	message_n2
exemplar	knowledge_n1
exertion	activity_n1
exfoliation	phenomenon_n1
exhalation	substance_n1
exhaustion	state_n4
exhibition	activity_n1
existence	state_n4
exocarp	Thing
exon	material_n1
exoskeleton	body_part_n1
exosphere	location_n1
expanse	property_n3
expansion	action_n1
expectancy	feeling_n1
expedition	activity_n1
expenditure	Thing
expense	Thing
experience	knowledge_n1
experiment	activity_n1
experimentation	process_n2
expert	person_n1
expertise	state_n4
explanation	message_n2
exploitation	activity_n1
exploration	action_n1
explorer	person_n1
explosion	event_n1
exposure	property_n3
expression	quality_n1
expulsion	event_n1
extension	Thing
extent	state_n4
extinction	state_n4
extinguisher	device_n1
extraction	phenomenon_n1
extremity	body_part_n1
eye	body_part_n1
eyebrow	Thing
eyeglasses	device_n1
eyelash	Thing
eyelid	body_part_n1
eyepiece	device_n1
eyesight	sense_n3
eyespot	artifact_n1
eyewash	Thing
fabric	artifact_n1
face	body_part_n1
facility	artifact_n1
fact	knowledge_n1
factor	event_n1
factory	artifact_n1
faculty	social_group_n1
failure	event_n1
fairground	location_n1
fairy	knowledge_n1
fairyland	knowledge_n1
faith	quality_n1
falcon	bird_n1
family	social_group_n1
fan	device_n1
fanaloka	animal_n1
fang	body_part_n1
fare	Thing
farewell	message_n2
farm	location_n1
farmer	person_n1
farmhouse	building_n1
farmland	location_n1
farmyard	artifact_n1
fashion	property_n3
fastener	person_n1
fate	event_n1
father	person_n1
fatigue	state_n4
faucet	device_n1
fault	Thing
fauna	Thing
favorite	process_n2
favoritism	knowledge_n1
fawn	animal_n1
fear	feeling_n1
feather	material_n1
feature	knowledge_n1
fecundation	event_n1
feedback	phenomenon_n1
feeder	animal_n1
feeler	body_part_n1
feeling	feeling_n1
feldspar	material_n1
feline	animal_n1
fellow	person_n1
felt	artifact_n1
fen	Thing
fence	artifact_n1
fermentation	phenomenon_n1
fern	plant_n2
ferret	animal_n1
fertilization	event_n1
fertilizer	material_n1
fervour	state_n4
festival	period_n1
fetus	animal_n1
fever	knowledge_n1
fiasco	event_n1
fiber	material_n1
fiberglass	artifact_n1
fibre	material_n1
fibrosis	state_n4
fiction	written_language_n1
fiddle	device_n1
field	location_n1
fife	device_n1
fifties	period_n1
fig	plant_part_n1
fighter	person_n1
figure	Thing
filament	material_n1
file	Thing
filing	Thing
fillet	substance_n1
filling	material_n1
film	event_n1
filtration	phenomenon_n1
fin	body_part_n1
finch	bird_n1
fine	Thing
finger	body_part_n1
fingernail	body_part_n1
fingerprint	written_language_n1
fingertip	location_n1
finish	quality_n1
fir	material_n1
fire	phenomenon_n1
fire-eater	person_n1
firefly	insect_n1
fireman	person_n1
fireplace	artifact_n1
fireweed	plant_n2
firewood	substance_n1
firework	material_n1
firm	social_group_n1
fish	fish_n1
fishbone	body_part_n1
fisher	person_n1
fisherman	person_n1
fishery	location_n1
fishhook	artifact_n1
fission	phenomenon_n1
fissure	shape_n2
fist	body_part_n1
fitness	quality_n1
fixation	state_n4
fixture	artifact_n1
fjord	water_n2
flag	artifact_n1
flagellum	body_part_n1
flagpole	device_n1
flagstaff	artifact_n1
flake	substance_n1
flame	phenomenon_n1
flamingo	bird_n1
flank	body_part_n1
flap	artifact_n1
flapjack	Thing
flash	property_n3
flashlight	device_n1
flask	artifact_n1
flatworm	animal_n1
flavor	process_n2
flavour	process_n2
flaw	state_n4
flea	insect_n1
fleece	material_n1
flesh	body_part_n1
flexibility	property_n3
flick	event_n1
flight	action_n1
flipper	body_part_n1
flock	Thing
floodplain	Thing
floor	artifact_n1
floorboard	artifact_n1
floret	plant_part_n1
floss	artifact_n1
flounder	fish_n1
flour	food_n1
flowchart	Thing
flower	plant_part_n1
flowerpot	artifact_n1
flu	illness_n1
fluctuation	event_n1
flue	artifact_n1
fluff	material_n1
fluid	substance_n1
fluke	phenomenon_n1
fluorine	element_n2
fluorite	material_n1
flurry	phenomenon_n1
flush	event_n1
flute	device_n1
flux	Thing
flycatcher	bird_n1
flyer	message_n2
flytrap	device_n1
flyway	location_n1
foam	shape_n2
fodder	food_n1
fog	phenomenon_n1
foil	artifact_n1
foliage	plant_part_n1
folk	Thing
follicle	body_part_n1
food	food_n1
fool	person_n1
foot	body_part_n1
football	activity_n1
footballer	person_n1
footpath	artifact_n1
footprint	Thing
footstep	sound_n4
footwear	clothing_n1
force	phenomenon_n1
forcefulness	property_n3
forecaster	person_n1
forehead	body_part_n1
forelimb	body_part_n1
forest	Thing
forestry	knowledge_n1
forget-me-not	plant_n2
fork	artifact_n1
formaldehyde	material_n1
formation	formation_n5
former	state_n4
formula	message_n2
fortitude	quality_n1
fortnight	period_n1
fortune	phenomenon_n1
fossa	shape_n2
fossil	Thing
fossilization	phenomenon_n1
foundation	Thing
founder	person_n1
founding	action_n1
fountain	artifact_n1
fowl	bird_n1
fox	animal_n1
foxglove	plant_n2
foxhound	animal_n1
foyer	artifact_n1
fraction	Thing
fracture	shape_n2
fragment	Thing
fragmentation	action_n1
frame	artifact_n1
framework	knowledge_n1
franc	definite_quantity_n1
freckle	artifact_n1
freedom	state_n4
freeman	person_n1
freeway	artifact_n1
freezer	artifact_n1
freight	artifact_n1
frequency	Thing
friar	person_n1
friction	phenomenon_n1
fridge	artifact_n1
friend	person_n1
friendliness	feeling_n1
friendship	state_n4
frigate	transport_n1
fright	feeling_n1
frill	artifact_n1
fringe	shape_n2
frog	animal_n1
frogfish	fish_n1
frond	plant_part_n1
front	location_n1
frost	substance_n1
frown	Thing
fructose	material_n1
fruit	plant_part_n1
frustration	feeling_n1
ft	definite_quantity_n1
fucus	microorganism_n1
fudge	food_n1
fuel	substance_n1
fulcrum	device_n1
fume	phenomenon_n1
function	quality_n1
fund	Thing
funfair	location_n1
fungus	plant_n2
fur	material_n1
furnace	artifact_n1
furniture	artifact_n1
fury	feeling_n1
fusion	event_n1
future	Thing
g	definite_quantity_n1
gabbro	material_n1
gadget	device_n1
gage	measuring_instrument_n1
gala	activity_n1
galago	animal_n1
galaxy	Thing
gale	phenomenon_n1
galena	material_n1
gall	substance_n1
gallery	artifact_n1
gallinule	bird_n1
gallon	definite_quantity_n1
game	animal_n1
gamekeeper	person_n1
gamete	Thing
gametogenesis	phenomenon_n1
gametophyte	plant_n2
gang	social_group_n1
gangplank	artifact_n1
gap	shape_n2
gar	fish_n1
garage	building_n1
garbage	material_n1
garden	location_n1
gardener	person_n1
gargoyle	artifact_n1
garland	artifact_n1
garment	clothing_n1
garter	artifact_n1
gas	phenomenon_n1
gasoline	material_n1
gastroenteritis	illness_n1
gastropod	animal_n1
gate	artifact_n1
gatherer	person_n1
gauge	measuring_instrument_n1
gaur	animal_n1
gauze	artifact_n1
gaze	activity_n1
gazelle	animal_n1
gear	equipment_n1
gecko	animal_n1
gee	definite_quantity_n1
gel	substance_n1
gelatin	material_n1
gemsbok	animal_n1
gender	Thing
gene	Thing
generalist	person_n1
generalization	process_n2
generation	Thing
generator	device_n1
genet	animal_n1
geneticist	person_n1
genetics	knowledge_n1
genie	knowledge_n1
genius	person_n1
genome	Thing
genotype	Thing
gentleman	person_n1
gentleness	Thing
genus	knowledge_n1
geography	knowledge_n1
geologist	person_n1
geology	knowledge_n1
geotropism	phenomenon_n1
geranium	plant_n2
gerbil	animal_n1
gerenuk	animal_n1
germ	microorganism_n1
germination	phenomenon_n1
getaway	event_n1
ghee	food_n1
ghost	knowledge_n1
giantess	knowledge_n1
giardia	microorganism_n1
giardiasis	state_n4
gibberellin	material_n1
gibbon	animal_n1
gift	Thing
gigantism	state_n4
gill	body_part_n1
gin	food_n1
ginger	plant_n2
gingerbread	Thing
ginkgo	plant_n2
giraffe	animal_n1
girder	device_n1
girl	person_n1
gizzard	body_part_n1
glacier	formation_n5
glance	activity_n1
gland	body_part_n1
glare	property_n3
glass	substance_n1
glassware	artifact_n1
glaze	artifact_n1
gleam	property_n3
glee	feeling_n1
glen	formation_n5
glider	transport_n1
glimpse	activity_n1
globe	artifact_n1
globule	shape_n2
glomerulus	body_part_n1
gloom	state_n4
glossary	artifact_n1
glove	clothing_n1
glucagon	substance_n1
glucose	material_n1
glue	material_n1
glutamine	material_n1
glycine	material_n1
glycogen	material_n1
glycolysis	phenomenon_n1
gneiss	material_n1
gnome	knowledge_n1
gnu	animal_n1
go-cart	transport_n1
go-kart	transport_n1
goal	knowledge_n1
goalie	person_n1
goat	animal_n1
goblin	knowledge_n1
goby	fish_n1
god	knowledge_n1
goddess	knowledge_n1
godparent	person_n1
godwit	bird_n1
gold	element_n2
goldeneye	insect_n1
goldfinch	bird_n1
goldfish	fish_n1
golf	activity_n1
gonad	body_part_n1
gondola	transport_n1
gondolier	person_n1
gong	device_n1
gonorrhea	illness_n1
goo	substance_n1
good-by	message_n2
good-bye	message_n2
goodbye	message_n2
goodness	quality_n1
goods	artifact_n1
goody	food_n1
goose	bird_n1
gooseberry	plant_n2
gopher	animal_n1
goral	animal_n1
gorge	location_n1
gorgonzola	food_n1
gorilla	animal_n1
gospel	knowledge_n1
gossip	auditory_communication_n1
government	social_group_n1
governor	person_n1
gown	clothing_n1
grace	property_n3
grade	social_group_n1
grader	person_n1
gradient	Thing
graduate	person_n1
graffito	artifact_n1
grain	material_n1
gram	definite_quantity_n1
gramophone	device_n1
gran	person_n1
grandad	person_n1
grandchild	person_n1
granddaughter	person_n1
grandfather	person_n1
grandma	person_n1
grandmother	person_n1
grandpa	person_n1
grandparent	person_n1
grandson	person_n1
granite	material_n1
grannie	person_n1
granny	person_n1
grape	plant_part_n1
grapefruit	plant_n2
graph	Thing
graphite	element_n2
grass	biome_n1
grasshopper	insect_n1
grassland	location_n1
grate	artifact_n1
grating	artifact_n1
grave	location_n1
gravel	material_n1
gravestone	artifact_n1
gravitation	phenomenon_n1
gravity	phenomenon_n1
gravy	food_n1
grease	material_n1
greengrocer	person_n1
greenhouse	building_n1
greenwood	biome_n1
greeting	message_n2
grenadine	food_n1
grid	artifact_n1
griffin	knowledge_n1
grill	artifact_n1
grison	animal_n1
grit	material_n1
groan	auditory_communication_n1
grocer	person_n1
grocery	artifact_n1
grog	food_n1
groom	person_n1
groove	shape_n2
gross	Thing
grotto	formation_n5
ground	Thing
group	social_group_n1
growth	phenomenon_n1
grub	food_n1
grunt	sound_n4
guanaco	animal_n1
guanine	material_n1
guard	person_n1
guardian	person_n1
guava	plant_n2
guenon	animal_n1
guereza	animal_n1
guest	person_n1
guidance	message_n2
guide	person_n1
guidebook	artifact_n1
guideline	knowledge_n1
guilder	definite_quantity_n1
guinea	Thing
guitar	device_n1
gulch	formation_n5
gulf	water_n2
gull	bird_n1
gully	formation_n5
gum	food_n1
gun	device_n1
guppy	fish_n1
gust	phenomenon_n1
gut	body_part_n1
gutter	artifact_n1
guy	person_n1
guzzler	person_n1
gym	artifact_n1
gymnast	person_n1
gymnastics	activity_n1
gymnosperm	plant_n2
gypsum	material_n1
gyroscope	device_n1
h	definite_quantity_n1
ha-ha	auditory_communication_n1
habit	knowledge_n1
habitat	location_n1
haddock	substance_n1
hagfish	animal_n1
hail	phenomenon_n1
hailstone	substance_n1
hair	Thing
hairbrush	artifact_n1
haircut	Thing
hairdresser	person_n1
hairline	Thing
half	definite_quantity_n1
half-brother	person_n1
halite	material_n1
hall	artifact_n1
hallmark	quality_n1
hallucination	state_n4
hallway	artifact_n1
halo	property_n3
halogen	Thing
ham	substance_n1
hamburger	food_n1
hamlet	social_group_n1
hammer	tool_n1
hammerhead	fish_n1
hammock	artifact_n1
hamster	animal_n1
hand	body_part_n1
handbag	artifact_n1
handball	equipment_n1
handedness	property_n3
handful	indefinite_quantity_n1
handiwork	artifact_n1
handkerchief	artifact_n1
handle	Thing
handlebar	artifact_n1
handstand	activity_n1
hanger	person_n1
hankie	artifact_n1
hanky	artifact_n1
hanuman	animal_n1
happening	event_n1
happiness	feeling_n1
harbor	location_n1
harbour	location_n1
hardness	property_n3
hardware	Thing
hare	animal_n1
harmony	quality_n1
harp	device_n1
hartebeest	animal_n1
harvest	event_n1
harvester	person_n1
haste	property_n3
hat	clothing_n1
hatching	Thing
hatchling	animal_n1
hatpin	device_n1
haven	artifact_n1
hawk	bird_n1
hawksbill	animal_n1
hawthorn	plant_n2
hay	food_n1
haystack	Thing
hazard	Thing
head	body_part_n1
headache	knowledge_n1
headdress	clothing_n1
header	written_language_n1
heading	written_language_n1
headlamp	device_n1
headline	written_language_n1
headmaster	person_n1
headmistress	person_n1
headphone	device_n1
headset	device_n1
health	state_n4
heap	Thing
heart	body_part_n1
heartbeat	event_n1
heartburn	knowledge_n1
heat	phenomenon_n1
heater	device_n1
heath	plant_n2
heather	plant_n2
heaven	location_n1
hedge	artifact_n1
hedgehog	animal_n1
hedgerow	artifact_n1
heel	location_n1
height	property_n3
heir	person_n1
helianthus	plant_n2
helicopter	transport_n1
helium	element_n2
helix	shape_n2
hellbender	animal_n1
hello	message_n2
helmet	artifact_n1
helper	person_n1
helping	indefinite_quantity_n1
hem	artifact_n1
hematite	material_n1
hemisphere	location_n1
hemoglobin	material_n1
hemophilia	state_n4
hen	bird_n1
henna	material_n1
henry	definite_quantity_n1
hepatitis	illness_n1
heptane	material_n1
herb	plant_n2
herbage	plant_n2
herbivore	animal_n1
herd	Thing
heredity	phenomenon_n1
heritage	knowledge_n1
hermit	person_n1
hero	person_n1
heron	bird_n1
herpes	illness_n1
herpetologist	person_n1
herring	Thing
hesitation	state_n4
heterogeneity	quality_n1
heterotroph	organism_n1
hexane	material_n1
hi	message_n2
hibernation	state_n4
hiccup	phenomenon_n1
hickory	material_n1
hide-and-seek	activity_n1
hideout	location_n1
hierarchy	Thing
high-rise	artifact_n1
highland	formation_n5
highway	artifact_n1
hike	action_n1
hiker	person_n1
hill	formation_n5
hillside	formation_n5
hilt	Thing
hind	fish_n1
hindrance	knowledge_n1
hinge	artifact_n1
hint	message_n2
hip	body_part_n1
hippo	animal_n1
hippopotamus	animal_n1
histamine	material_n1
histogram	Thing
historian	person_n1
history	Thing
hitchhiker	person_n1
hive	social_group_n1
hl	definite_quantity_n1
hoatzin	bird_n1
hobby	activity_n1
hockey	activity_n1
hoe	tool_n1
hog	animal_n1
holder	device_n1
holding	activity_n1
hole	location_n1
holiday	period_n1
hollow	shape_n2
holly	plant_n2
hollyhock	plant_n2
home	location_n1
homeobox	Thing
homeostasis	state_n4
homeowner	person_n1
homework	activity_n1
homicide	action_n1
homo	person_n1
homology	quality_n1
honesty	quality_n1
honey	food_n1
honeybee	insect_n1
honeycomb	artifact_n1
honeymoon	period_n1
honour	quality_n1
hood	clothing_n1
hooey	message_n2
hoof	body_part_n1
hook	device_n1
hookworm	animal_n1
hoop	artifact_n1
hooray	message_n2
hopper	artifact_n1
horizon	location_n1
hormone	substance_n1
horn	body_part_n1
hornblende	material_n1
hornet	insect_n1
hornwort	plant_n2
horoscope	message_n2
horror	feeling_n1
horse	animal_n1
horseback	body_part_n1
horsefly	insect_n1
horsehair	material_n1
horseman	person_n1
horseshoe	artifact_n1
horticulture	event_n1
hose	artifact_n1
hosepipe	artifact_n1
hospital	building_n1
host	person_n1
hostage	person_n1
hostility	Thing
hotel	building_n1
hotness	property_n3
hotspot	location_n1
hound	animal_n1
hour	Thing
house	building_n1
houseboat	transport_n1
housefly	insect_n1
household	social_group_n1
houseplant	plant_n2
howl	auditory_communication_n1
howler	animal_n1
hub	Thing
huckleberry	plant_n2
hue	property_n3
hug	activity_n1
hull	artifact_n1
human	person_n1
humanity	animal_n1
humidity	state_n4
hummingbird	bird_n1
hump	shape_n2
humpback	state_n4
humus	material_n1
hunger	state_n4
hunter	person_n1
huntsman	person_n1
hurricane	phenomenon_n1
husband	person_n1
husk	material_n1
hut	artifact_n1
hutch	artifact_n1
hyacinth	material_n1
hydra	animal_n1
hydrocarbon	material_n1
hydrogen	element_n2
hydrosphere	location_n1
hydroxide	material_n1
hyena	animal_n1
hygiene	state_n4
hymn	auditory_communication_n1
hypermarket	artifact_n1
hypersecretion	phenomenon_n1
hypertension	state_n4
hyperventilation	phenomenon_n1
hypha	material_n1
hyponym	Thing
hypothalamus	body_part_n1
hypothesis	message_n2
hyrax	animal_n1
ibex	animal_n1
ibuprofen	Thing
ice	substance_n1
iceberg	formation_n5
icebox	artifact_n1
icicle	substance_n1
icon	artifact_n1
id	knowledge_n1
idea	knowledge_n1
identification	action_n1
identity	process_n2
idiot	person_n1
igloo	artifact_n1
iguana	animal_n1
ileum	body_part_n1
illness	illness_n1
illumination	state_n4
illusion	knowledge_n1
illustration	Thing
image	artifact_n1
imagination	knowledge_n1
imbalance	state_n4
imitation	artifact_n1
immigration	action_n1
immunity	state_n4
immunization	activity_n1
immunodeficiency	state_n4
impact	event_n1
impairment	state_n4
impala	animal_n1
imperfection	state_n4
implantation	activity_n1
implement	artifact_n1
importance	quality_n1
imposter	person_n1
impression	knowledge_n1
improvement	action_n1
impulse	Thing
impurity	state_n4
inability	knowledge_n1
inactivity	state_n4
incentive	Thing
inch	definite_quantity_n1
incident	event_n1
incision	action_n1
incisor	body_part_n1
incline	formation_n5
inclusion	state_n4
income	Thing
incubation	activity_n1
incubator	equipment_n1
index	message_n2
indication	Thing
indicator	message_n2
indigo	material_n1
individual	person_n1
inducement	Thing
induction	event_n1
industry	social_group_n1
inertia	phenomenon_n1
infancy	period_n1
infant	person_n1
infection	state_n4
inference	process_n2
infertility	state_n4
infiltration	activity_n1
infirmity	state_n4
inflammation	knowledge_n1
inflation	action_n1
inflorescence	phenomenon_n1
influenza	illness_n1
information	message_n2
infrastructure	property_n3
ingenuity	knowledge_n1
ingestion	phenomenon_n1
ingredient	Thing
inhabitant	person_n1
inhalation	phenomenon_n1
inheritance	action_n1
initiation	event_n1
initiative	Thing
injection	action_n1
injury	state_n4
ink	substance_n1
inn	building_n1
innovation	artifact_n1
input	knowledge_n1
inquiry	process_n2
insect	insect_n1
insecticide	material_n1
insectivore	animal_n1
insertion	action_n1
insight	knowledge_n1
insolation	illness_n1
inspection	activity_n1
inspector	person_n1
inspiration	knowledge_n1
instance	event_n1
instant	period_n1
instinct	knowledge_n1
institute	social_group_n1
institution	social_group_n1
instruction	message_n2
instructor	person_n1
instrument	device_n1
instrumentality	artifact_n1
insulation	artifact_n1
insulator	material_n1
insulin	substance_n1
intake	phenomenon_n1
intangible	Thing
integrity	state_n4
intelligence	knowledge_n1
intensifier	Thing
intensity	property_n3
intention	knowledge_n1
interaction	action_n1
interconnectedness	state_n4
intercourse	event_n1
interdependence	Thing
interest	state_n4
interference	process_n2
interior	location_n1
interpretation	knowledge_n1
interrelationship	Thing
interruption	event_n1
intersection	knowledge_n1
interval	Thing
intestine	body_part_n1
intoxication	state_n4
intrigue	knowledge_n1
introduction	action_n1
intron	material_n1
intruder	person_n1
intrusion	event_n1
intuition	process_n2
invader	person_n1
invalid	person_n1
invasion	activity_n1
invention	knowledge_n1
inventor	person_n1
investigation	process_n2
invitation	written_language_n1
invite	written_language_n1
involvement	event_n1
iodine	element_n2
ion	Thing
iris	plant_n2
iron	element_n2
irregularity	activity_n1
irrigation	activity_n1
irritant	knowledge_n1
irritation	state_n4
island	Thing
islander	person_n1
isle	Thing
isolation	state_n4
isotope	substance_n1
issue	knowledge_n1
isthmus	Thing
item	Thing
ivory	material_n1
jabot	artifact_n1
jack	device_n1
jackal	animal_n1
jackdaw	bird_n1
jacket	clothing_n1
jackhammer	tool_n1
jackrabbit	animal_n1
jade	Thing
jaguar	animal_n1
jaguarundi	animal_n1
jail	artifact_n1
jailer	person_n1
jam	food_n1
jamboree	activity_n1
janitor	person_n1
jar	artifact_n1
jasmine	plant_n2
jaw	body_part_n1
jay	bird_n1
jazz	auditory_communication_n1
jean	clothing_n1
jejunum	body_part_n1
jello	food_n1
jelly	food_n1
jellyfish	animal_n1
jerboa	animal_n1
jerk	action_n1
jersey	clothing_n1
jet	transport_n1
jewel	artifact_n1
jeweler	person_n1
jewellery	artifact_n1
jewelry	artifact_n1
jiffy	period_n1
jig	activity_n1
jigsaw	tool_n1
jird	animal_n1
job	activity_n1
jockey	person_n1
jog	action_n1
john	artifact_n1
joint	body_part_n1
joke	message_n2
joker	person_n1
joule	definite_quantity_n1
journal	written_language_n1
journalist	person_n1
journey	action_n1
joy	feeling_n1
judge	person_n1
judgment	knowledge_n1
jug	artifact_n1
juggle	activity_n1
juggler	person_n1
juice	food_n1
jumble	state_n4
jumper	clothing_n1
junco	bird_n1
jungle	biome_n1
juniper	plant_n2
junk	material_n1
justice	quality_n1
jute	material_n1
kaleidoscope	artifact_n1
kangaroo	animal_n1
kaolinite	material_n1
karate	activity_n1
karyotype	property_n3
katydid	insect_n1
kayak	transport_n1
kazoo	device_n1
kebab	food_n1
keeper	person_n1
kelp	microorganism_n1
kelvin	definite_quantity_n1
kennel	building_n1
keratin	material_n1
kernel	plant_part_n1
kerosene	material_n1
kestrel	bird_n1
ketchup	food_n1
kettle	artifact_n1
key	device_n1
keyboard	device_n1
keyhole	artifact_n1
kg	definite_quantity_n1
khan	person_n1
kiang	animal_n1
kibbutz	social_group_n1
kid	person_n1
kidnapper	person_n1
kidney	body_part_n1
kiley	device_n1
killer	person_n1
kiln	artifact_n1
kilo	definite_quantity_n1
kilocalorie	definite_quantity_n1
kilogram	definite_quantity_n1
kiloliter	definite_quantity_n1
kilometer	definite_quantity_n1
kilometre	definite_quantity_n1
kilowatt	definite_quantity_n1
kilt	clothing_n1
kin	person_n1
kind	knowledge_n1
kindness	quality_n1
king	person_n1
kingdom	Thing
kingfisher	bird_n1
kinkajou	animal_n1
kipper	Thing
kit	equipment_n1
kitchen	artifact_n1
kite	artifact_n1
kitten	animal_n1
kittiwake	bird_n1
kitty	animal_n1
kiwi	plant_n2
km	definite_quantity_n1
knee	body_part_n1
knife	tool_n1
knight	person_n1
knob	Thing
knot	Thing
know-how	knowledge_n1
knowledge	knowledge_n1
knuckle	body_part_n1
koala	animal_n1
kob	animal_n1
krill	animal_n1
kudu	animal_n1
kudzu	plant_n2
kyphosis	state_n4
l	definite_quantity_n1
la	Thing
lab	location_n1
labium	body_part_n1
labor	activity_n1
laboratory	location_n1
lac	material_n1
lack	state_n4
lacrosse	activity_n1
lactation	period_n1
lactose	material_n1
lad	person_n1
ladder	artifact_n1
lady	person_n1
ladybird	insect_n1
ladybug	insect_n1
lagoon	water_n2
lake	water_n2
lamb	animal_n1
lamp	device_n1
lamprey	animal_n1
lampshade	artifact_n1
lancelet	animal_n1
land	Thing
landfill	formation_n5
landmark	location_n1
landmass	Thing
landscape	location_n1
landslide	event_n1
lane	artifact_n1
language	written_language_n1
langur	animal_n1
lantern	device_n1
lap	body_part_n1
laptop	device_n1
larder	food_n1
largemouth	fish_n1
larva	animal_n1
larynx	body_part_n1
lasagna	food_n1
laser	device_n1
latch	device_n1
latency	Thing
latex	material_n1
lather	shape_n2
latitude	location_n1
latter	state_n4
laughter	auditory_communication_n1
launcher	artifact_n1
laundry	clothing_n1
laurel	plant_n2
lava	material_n1
law	written_language_n1
lawn	location_n1
layer	artifact_n1
lb	definite_quantity_n1
lead	element_n2
leader	person_n1
leaf	plant_part_n1
leafhopper	insect_n1
leaflet	body_part_n1
league	social_group_n1
leakage	event_n1
learner	person_n1
leather	material_n1
leatherback	animal_n1
lechwe	animal_n1
lecture	event_n1
ledge	formation_n5
lee	location_n1
leech	animal_n1
leek	plant_n2
leg	body_part_n1
legend	written_language_n1
legging	clothing_n1
legume	plant_n2
leisure	period_n1
lemming	animal_n1
lemon	plant_part_n1
lemonade	food_n1
lemur	animal_n1
length	property_n3
lens	device_n1
lense	device_n1
lentil	substance_n1
leopard	material_n1
leprechaun	knowledge_n1
leptospira	microorganism_n1
lesson	activity_n1
letter	written_language_n1
lettuce	plant_n2
letup	Thing
leukocyte	Thing
level	property_n3
lever	artifact_n1
liar	person_n1
librarian	person_n1
library	artifact_n1
license	written_language_n1
lichen	illness_n1
lid	body_part_n1
life	state_n4
lifeboat	transport_n1
lifeguard	person_n1
lifespan	period_n1
lifestyle	property_n3
lifetime	period_n1
liftoff	event_n1
ligament	body_part_n1
ligation	action_n1
light	phenomenon_n1
lightbulb	device_n1
lighthouse	artifact_n1
lightness	property_n3
lightning	phenomenon_n1
lignin	material_n1
likelihood	quality_n1
likeness	quality_n1
liking	feeling_n1
lilac	plant_n2
lily	plant_n2
limb	body_part_n1
limelight	state_n4
limestone	material_n1
limit	property_n3
limitation	knowledge_n1
line	Thing
lineage	social_group_n1
liner	action_n1
ling	plant_n2
linguistics	knowledge_n1
lining	artifact_n1
link	Thing
linkage	Thing
lion	animal_n1
lioness	animal_n1
lip	body_part_n1
lipase	material_n1
lipid	material_n1
lipstick	artifact_n1
liquefaction	phenomenon_n1
liquid	substance_n1
liquidation	action_n1
liquor	food_n1
list	message_n2
listener	person_n1
liter	definite_quantity_n1
literacy	knowledge_n1
literature	written_language_n1
lithium	element_n2
lithosphere	location_n1
litmus	material_n1
litre	definite_quantity_n1
litter	Thing
liver	body_part_n1
liverwort	organism_n1
livestock	animal_n1
lizard	animal_n1
llama	animal_n1
load	artifact_n1
loaf	substance_n1
lobe	body_part_n1
lobster	animal_n1
locality	location_n1
location	location_n1
locker	artifact_n1
locket	artifact_n1
locomotion	quality_n1
locus	location_n1
locust	insect_n1
loft	artifact_n1
log	material_n1
logic	knowledge_n1
logo	Thing
lollipop	food_n1
lolly	Thing
loneliness	state_n4
loo	artifact_n1
loofah	material_n1
loon	person_n1
loot	Thing
lord	person_n1
lordship	quality_n1
lore	knowledge_n1
lorikeet	bird_n1
lorry	transport_n1
loss	event_n1
lot	indefinite_quantity_n1
lotion	artifact_n1
lottery	event_n1
loudness	property_n3
loudspeaker	device_n1
louse	insect_n1
luck	state_n4
luggage	artifact_n1
lull	Thing
lullaby	auditory_communication_n1
lumbago	knowledge_n1
lumber	artifact_n1
lump	Thing
lunch	food_n1
lunchtime	knowledge_n1
lung	body_part_n1
lungfish	fish_n1
lupus	illness_n1
luster	property_n3
lye	material_n1
lymph	substance_n1
lymphocyte	Thing
lynx	animal_n1
lysine	material_n1
lysosome	body_part_n1
m	definite_quantity_n1
ma	person_n1
mac	clothing_n1
macaque	animal_n1
macaroni	person_n1
macaw	bird_n1
mace	person_n1
machine	device_n1
machinery	device_n1
macroevolution	phenomenon_n1
madam	person_n1
madame	person_n1
madness	state_n4
magazine	artifact_n1
magic	knowledge_n1
magician	person_n1
magma	material_n1
magnesium	element_n2
magnet	device_n1
magnetism	phenomenon_n1
magnetite	material_n1
magnification	action_n1
magnifier	device_n1
magnitude	property_n3
magnolia	Thing
magpie	bird_n1
maid	person_n1
maidenhair	plant_n2
mainstream	knowledge_n1
maintenance	action_n1
majesty	quality_n1
majority	property_n3
make-up	artifact_n1
maker	person_n1
makeup	property_n3
malaria	state_n4
mall	artifact_n1
mallard	bird_n1
mama	person_n1
mammal	animal_n1
man	person_n1
management	event_n1
manager	person_n1
manatee	animal_n1
mandarin	plant_n2
mandible	body_part_n1
mandolin	device_n1
mandrill	animal_n1
mane	Thing
mangabey	animal_n1
mango	plant_n2
mangrove	plant_n2
manipulation	action_n1
manner	property_n3
manor	building_n1
mansion	location_n1
mantelpiece	device_n1
mantis	insect_n1
mantle	Thing
manual	artifact_n1
manufacturer	social_group_n1
manure	material_n1
map	artifact_n1
maple	material_n1
mara	animal_n1
marathon	activity_n1
marble	material_n1
margarine	food_n1
margay	animal_n1
margin	shape_n2
maria	location_n1
marigold	plant_n2
marijuana	plant_n2
marjoram	plant_n2
marker	artifact_n1
market	activity_n1
markhor	animal_n1
marmalade	food_n1
marmoset	animal_n1
marmot	animal_n1
marriage	state_n4
marrow	body_part_n1
marsh	Thing
marshland	Thing
marshmallow	food_n1
mart	artifact_n1
marten	animal_n1
martin	bird_n1
martini	food_n1
marzipan	food_n1
mascot	organism_n1
mason	person_n1
mass	property_n3
mast	artifact_n1
master	person_n1
mastery	state_n4
mastodon	animal_n1
mat	artifact_n1
matchbox	artifact_n1
matchstick	artifact_n1
mate	animal_n1
mater	person_n1
material	material_n1
math	knowledge_n1
mathematician	person_n1
mathematics	knowledge_n1
matrix	Thing
matt	property_n3
matter	substance_n1
mattress	artifact_n1
maturation	phenomenon_n1
maturity	period_n1
max	Thing
maxwell	Thing
may	plant_n2
mayfly	insect_n1
mayonnaise	food_n1
mayor	person_n1
maze	artifact_n1
meadow	location_n1
meadowlark	bird_n1
meal	food_n1
mealworm	animal_n1
measles	illness_n1
measurement	activity_n1
meat	substance_n1
meatball	food_n1
mechanic	person_n1
mechanism	device_n1
medal	Thing
medication	Thing
medicine	knowledge_n1
medium	event_n1
medusa	animal_n1
meerkat	animal_n1
meeting	social_group_n1
megawatt	definite_quantity_n1
meiosis	phenomenon_n1
melanin	material_n1
melanocyte	Thing
melatonin	substance_n1
melody	auditory_communication_n1
melon	plant_part_n1
meltwater	material_n1
member	person_n1
membrane	artifact_n1
memorandum	Thing
memorization	process_n2
memory	knowledge_n1
menace	Thing
menarche	event_n1
meningitis	illness_n1
meniscus	body_part_n1
menopause	Thing
menstruation	phenomenon_n1
menu	message_n2
merchant	person_n1
mercury	element_n2
meringue	artifact_n1
meristem	plant_part_n1
mesoderm	body_part_n1
mesosphere	location_n1
mess	state_n4
message	message_n2
messenger	person_n1
metabolism	phenomenon_n1
metadata	Thing
metal	element_n2
metamorphism	phenomenon_n1
metamorphosis	phenomenon_n1
metaphase	period_n1
meteor	phenomenon_n1
meteorite	Thing
meteorologist	person_n1
meteorology	message_n2
meter	definite_quantity_n1
methane	material_n1
methionine	material_n1
method	knowledge_n1
methodology	knowledge_n1
metre	definite_quantity_n1
metro	social_group_n1
mg	definite_quantity_n1
mi	definite_quantity_n1
mica	material_n1
microbe	microorganism_n1
microbiology	knowledge_n1
microevolution	phenomenon_n1
micrometer	measuring_instrument_n1
micronutrient	substance_n1
microorganism	microorganism_n1
microphone	device_n1
microscope	device_n1
microtubule	body_part_n1
microwave	phenomenon_n1
midday	knowledge_n1
middle	location_n1
midge	insect_n1
midnight	knowledge_n1
midwife	person_n1
migraine	knowledge_n1
migrant	person_n1
migration	event_n1
migrator	person_n1
mike	device_n1
mile	definite_quantity_n1
mileage	Thing
milestone	event_n1
milk	food_n1
milkman	person_n1
milkweed	plant_n2
mill	device_n1
millepede	animal_n1
miller	person_n1
milligram	definite_quantity_n1
milliliter	definite_quantity_n1
millimeter	definite_quantity_n1
millionaire	person_n1
millipede	animal_n1
milo	plant_n2
mimic	person_n1
mimicry	activity_n1
min	Thing
mincemeat	food_n1
mind	knowledge_n1
minder	person_n1
mine	artifact_n1
miner	person_n1
mineral	material_n1
minister	person_n1
mink	animal_n1
minority	social_group_n1
minstrel	person_n1
mint	food_n1
minus	activity_n1
minute	Thing
miracle	event_n1
mirror	device_n1
mischief	activity_n1
misconception	knowledge_n1
misfortune	event_n1
mishap	phenomenon_n1
misinformation	message_n2
miss	event_n1
missile	transport_n1
mission	social_group_n1
mist	phenomenon_n1
mistake	event_n1
mistletoe	organism_n1
mite	animal_n1
mitochondrion	body_part_n1
mitosis	phenomenon_n1
mitt	equipment_n1
mitten	clothing_n1
mix-up	event_n1
mixer	artifact_n1
mixture	substance_n1
ml	definite_quantity_n1
mm	definite_quantity_n1
moa	bird_n1
moat	artifact_n1
mob	social_group_n1
mobile	shape_n2
mocassin	artifact_n1
moccasin	artifact_n1
mode	property_n3
modem	equipment_n1
modification	action_n1
module	knowledge_n1
moisture	state_n4
molar	body_part_n1
mold	shape_n2
mole	definite_quantity_n1
molecule	Thing
molehill	formation_n5
mollusc	animal_n1
mollusk	animal_n1
molly	fish_n1
mom	person_n1
moment	Thing
momentum	property_n3
monarch	person_n1
monastery	building_n1
money	Thing
mongoose	animal_n1
monitor	device_n1
monk	person_n1
monkey	animal_n1
monocot	plant_n2
monomer	material_n1
monosaccharide	material_n1
monotreme	animal_n1
monoxide	material_n1
monster	knowledge_n1
monte	activity_n1
month	period_n1
monument	artifact_n1
mood	feeling_n1
moon	Thing
moonbeam	phenomenon_n1
moonlight	phenomenon_n1
moose	animal_n1
mop	artifact_n1
moraine	material_n1
morality	quality_n1
morning	period_n1
morocco	material_n1
mortality	property_n3
morula	animal_n1
mosaic	artifact_n1
mosque	building_n1
mosquito	insect_n1
mosquitofish	fish_n1
moss	organism_n1
moth	insect_n1
mother	person_n1
motility	quality_n1
motion	event_n1
motivation	Thing
motive	Thing
motivity	quality_n1
motor	device_n1
motorbike	transport_n1
motorboat	transport_n1
motorway	artifact_n1
mound	equipment_n1
mount	formation_n5
mountain	formation_n5
mountaineering	action_n1
mountainside	formation_n5
mouse	animal_n1
moustache	Thing
mouth	body_part_n1
mouthful	indefinite_quantity_n1
mouthpart	body_part_n1
movement	action_n1
mover	person_n1
movie	event_n1
mower	tool_n1
mph	Thing
muck	material_n1
mucus	substance_n1
mud	material_n1
muddle	state_n4
mudslide	event_n1
mulch	artifact_n1
mule	animal_n1
mullet	fish_n1
multiplication	activity_n1
multitude	indefinite_quantity_n1
mummy	person_n1
mumps	illness_n1
municipality	location_n1
muntjac	animal_n1
mural	artifact_n1
murder	action_n1
murderer	person_n1
murmur	sound_n4
muscle	body_part_n1
muse	knowledge_n1
museum	artifact_n1
mush	Thing
mushroom	plant_n2
music	auditory_communication_n1
musician	person_n1
musk	substance_n1
muskmelon	plant_n2
muskrat	material_n1
mussel	substance_n1
mustache	Thing
mustard	plant_n2
mutagen	Thing
mutant	organism_n1
mutation	organism_n1
mutualism	Thing
muzzle	artifact_n1
mycelium	plant_part_n1
mycology	knowledge_n1
myelin	material_n1
mynah	bird_n1
myofibril	material_n1
myosin	material_n1
myriad	indefinite_quantity_n1
mystery	state_n4
nail	device_n1
nan	person_n1
nap	period_n1
napkin	artifact_n1
narrator	person_n1
narwhal	animal_n1
nation	social_group_n1
naturalist	person_n1
nature	Thing
nausea	knowledge_n1
navigation	activity_n1
nearness	Thing
nebula	material_n1
necessity	state_n4
neck	body_part_n1
necklace	artifact_n1
nectar	substance_n1
needle	plant_part_n1
negation	message_n2
neigh	sound_n4
neighbor	person_n1
neighborhood	location_n1
neighbour	person_n1
nekton	organism_n1
nematode	animal_n1
neocortex	body_part_n1
neon	element_n2
nephron	body_part_n1
nerve	body_part_n1
nest	Thing
net	device_n1
netball	activity_n1
nettle	plant_n2
network	Thing
neuron	Thing
neurotransmitter	material_n1
neutrality	event_n1
neutron	Thing
newcomer	person_n1
news	message_n2
newsagent	person_n1
newsletter	message_n2
newspaper	artifact_n1
newt	animal_n1
newton	definite_quantity_n1
nib	location_n1
nibbler	person_n1
niche	state_n4
nickel	element_n2
nicotine	material_n1
niece	person_n1
night	period_n1
nightcap	indefinite_quantity_n1
nightdress	clothing_n1
nightfall	knowledge_n1
nightmare	state_n4
nighttime	period_n1
nigra	person_n1
nil	Thing
nilgai	animal_n1
nimbus	phenomenon_n1
nipper	person_n1
nipple	body_part_n1
nit	Thing
nitrate	material_n1
nitrogen	element_n2
nm	definite_quantity_n1
nobody	person_n1
nod	action_n1
node	shape_n2
noise	sound_v2
nomenclature	Thing
nondisjunction	Thing
nonmetal	element_n2
nonsense	message_n2
nonsmoker	person_n1
noodle	substance_n1
nook	location_n1
noon	knowledge_n1
norm	Thing
nose	body_part_n1
nostril	body_part_n1
notation	written_language_n1
note	written_language_n1
notebook	artifact_n1
nothing	Thing
nothingness	state_n4
notice	process_n2
notion	knowledge_n1
notochord	body_part_n1
nought	definite_quantity_n1
noun	Thing
nourishment	food_n1
nova	heavenly_body_n1
novel	written_language_n1
nozzle	artifact_n1
nucleon	Thing
nucleotide	material_n1
nucleus	body_part_n1
nudge	action_n1
nugget	Thing
nuisance	knowledge_n1
numbat	animal_n1
number	property_n3
numbness	knowledge_n1
nun	person_n1
nurse	person_n1
nursery	artifact_n1
nut	plant_part_n1
nutcracker	artifact_n1
nutria	animal_n1
nutrient	food_n1
nutrition	phenomenon_n1
nutshell	Thing
nyala	animal_n1
nylon	material_n1
nymph	knowledge_n1
oak	material_n1
oar	artifact_n1
oasis	location_n1
oat	plant_n2
oatmeal	food_n1
obesity	property_n3
object	Thing
obligation	event_n1
observation	knowledge_n1
observatory	building_n1
observer	person_n1
obsidian	material_n1
obstacle	knowledge_n1
occasion	event_n1
occupant	person_n1
occupation	activity_n1
occurrence	event_n1
ocean	water_n2
ocelot	animal_n1
octane	material_n1
octopus	substance_n1
odometer	measuring_instrument_n1
odor	property_n3
offal	Thing
offense	activity_n1
offer	message_n2
office	artifact_n1
officer	person_n1
official	person_n1
offset	Thing
offshoot	phenomenon_n1
offspring	person_n1
ogre	person_n1
ohm	definite_quantity_n1
oil	material_n1
okapi	animal_n1
oleander	plant_n2
omega	event_n1
omelette	food_n1
omission	event_n1
omnivore	person_n1
oncogene	Thing
onion	plant_part_n1
onset	event_n1
ontology	knowledge_n1
oocyte	Thing
oogenesis	phenomenon_n1
opener	event_n1
opera	auditory_communication_n1
operation	activity_n1
operator	Thing
operon	material_n1
opinion	knowledge_n1
opossum	animal_n1
opponent	person_n1
opportunity	state_n4
opposition	action_n1
opsonin	material_n1
optician	person_n1
optimisation	action_n1
optimization	action_n1
option	process_n2
orange	plant_part_n1
orangutan	animal_n1
orb	body_part_n1
orbit	location_n1
orca	animal_n1
orchard	location_n1
orchestra	social_group_n1
orchid	plant_n2
order	Thing
ordnance	artifact_n1
ore	material_n1
organ	body_part_n1
organelle	body_part_n1
organism	organism_n1
organization	social_group_n1
organizer	person_n1
orientation	activity_n1
origin	location_n1
oriole	bird_n1
ornament	artifact_n1
ornithischian	animal_n1
ornithologist	person_n1
orphan	person_n1
orthomyxovirus	microorganism_n1
oryx	animal_n1
os	body_part_n1
osmosis	phenomenon_n1
osprey	bird_n1
ossification	phenomenon_n1
osteoarthritis	illness_n1
osteoblast	Thing
osteoclast	Thing
osteocyte	Thing
osteoporosis	state_n4
ostrich	person_n1
otter	material_n1
ounce	definite_quantity_n1
outbreak	event_n1
outcome	event_n1
outfit	clothing_n1
outgrowth	phenomenon_n1
outlet	artifact_n1
output	artifact_n1
oval	shape_n2
ovary	plant_part_n1
oven	artifact_n1
overcast	phenomenon_n1
overhang	artifact_n1
overlap	knowledge_n1
overload	artifact_n1
overpopulation	Thing
override	device_n1
overview	message_n2
ovulation	phenomenon_n1
ovule	plant_part_n1
ovum	Thing
owl	bird_n1
owner	person_n1
ownership	Thing
ox	animal_n1
oxaloacetate	material_n1
oxbow	Thing
oxidation	phenomenon_n1
oxide	material_n1
oxygen	element_n2
oxytocin	substance_n1
oyster	animal_n1
ozone	substance_n1
pa	person_n1
paca	animal_n1
pace	Thing
pachyderm	animal_n1
pack	artifact_n1
package	Thing
packer	person_n1
packet	Thing
pad	plant_part_n1
paddy	location_n1
pademelon	animal_n1
page	material_n1
pail	artifact_n1
pain	knowledge_n1
paintball	artifact_n1
paintbrush	device_n1
painter	person_n1
painting	artifact_n1
pair	definite_quantity_n1
pal	person_n1
palace	building_n1
paleontologist	person_n1
palm	body_part_n1
pampas	Thing
pan	artifact_n1
pancake	substance_n1
pancreas	body_part_n1
panda	animal_n1
pane	artifact_n1
pangolin	animal_n1
panic	feeling_n1
pansy	plant_n2
pant	Thing
panther	animal_n1
panto	activity_n1
pantry	artifact_n1
pap	message_n2
papa	person_n1
papaya	plant_n2
paper	material_n1
paperback	artifact_n1
paperclip	device_n1
papilloma	illness_n1
parachute	equipment_n1
parade	event_n1
paragraph	written_language_n1
parakeet	bird_n1
paralysis	state_n4
paramecia	microorganism_n1
paramecium	microorganism_n1
parameter	knowledge_n1
parasite	organism_n1
parasitism	Thing
parathyroid	body_part_n1
parcel	artifact_n1
pardon	written_language_n1
parent	person_n1
parhelion	artifact_n1
park	location_n1
parliament	social_group_n1
parrot	bird_n1
parsley	plant_n2
part	body_part_n1
participant	person_n1
participation	event_n1
participle	Thing
particle	material_n1
particular	knowledge_n1
partner	person_n1
partridge	Thing
party	social_group_n1
pascal	definite_quantity_n1
passage	action_n1
passageway	artifact_n1
passenger	person_n1
passion	feeling_n1
passport	message_n2
past	period_n1
pasta	substance_n1
paste	material_n1
pastry	food_n1
pasture	location_n1
pat	sound_n4
patas	animal_n1
patch	location_n1
patent	written_language_n1
path	location_n1
pathogen	microorganism_n1
pathway	artifact_n1
patience	Thing
patient	person_n1
patrol	social_group_n1
patrolman	person_n1
patter	event_n1
pattern	knowledge_n1
pause	Thing
pavement	artifact_n1
paw	body_part_n1
pay	Thing
payment	Thing
pe	Thing
pea	substance_n1
peace	state_n4
peach	plant_part_n1
peacock	insect_n1
peak	indefinite_quantity_n1
peanut	plant_n2
pear	plant_part_n1
pearl	artifact_n1
pebble	Thing
pecan	material_n1
peccary	animal_n1
pedal	artifact_n1
pedigree	social_group_n1
peekaboo	activity_n1
peel	plant_part_n1
peeler	device_n1
peep	sound_n4
peephole	artifact_n1
peg	device_n1
pelican	bird_n1
pellet	shape_n2
pelvis	body_part_n1
pelycosaur	animal_n1
pen	artifact_n1
penalty	event_n1
pencil	artifact_n1
pendulum	equipment_n1
penetration	activity_n1
pengo	definite_quantity_n1
penguin	bird_n1
penicillin	Thing
penis	body_part_n1
penknife	tool_n1
penny	definite_quantity_n1
people	Thing
pepper	plant_n2
peppermint	plant_n2
pepsin	material_n1
peptidase	material_n1
percent	Thing
percentage	Thing
perception	knowledge_n1
perch	fish_n1
percolation	Thing
percussion	activity_n1
perforation	artifact_n1
performance	event_n1
performer	person_n1
perfume	artifact_n1
perianth	plant_part_n1
perihelion	location_n1
period	period_n1
periosteum	body_part_n1
periscope	device_n1
peristalsis	phenomenon_n1
periwinkle	plant_n2
permafrost	Thing
permeability	property_n3
permission	message_n2
peroxide	substance_n1
person	person_n1
personality	Thing
perspective	knowledge_n1
perspiration	substance_n1
pest	person_n1
pesticide	material_n1
pet	animal_n1
petal	plant_part_n1
petiole	plant_part_n1
petrol	material_n1
petroleum	material_n1
pewter	substance_n1
phagocyte	Thing
phagocytosis	phenomenon_n1
phantom	knowledge_n1
pharmacist	person_n1
pharynx	body_part_n1
phase	phenomenon_n1
phasmid	insect_n1
pheasant	bird_n1
phenomenon	phenomenon_n1
phenotype	property_n3
pheromone	substance_n1
philosopher	person_n1
phloem	plant_part_n1
phone	equipment_n1
phonebook	artifact_n1
phonograph	device_n1
phosphate	material_n1
phospholipid	material_n1
phosphorus	element_n2
photo	artifact_n1
photocopier	equipment_n1
photograph	artifact_n1
photographer	person_n1
photography	activity_n1
photon	Thing
photosynthesis	phenomenon_n1
phototropism	phenomenon_n1
phrase	Thing
phylogeny	phenomenon_n1
phylum	social_group_n1
physician	person_n1
physiology	knowledge_n1
phytoplankton	plant_n2
pi	definite_quantity_n1
pianist	person_n1
piano	device_n1
pichi	plant_n2
pickerel	Thing
pickle	food_n1
pickup	transport_n1
picnic	food_n1
picture	artifact_n1
pie	substance_n1
piece	Thing
pier	artifact_n1
pig	animal_n1
pigeon	bird_n1
piglet	animal_n1
pigment	material_n1
pigpen	artifact_n1
pigsty	artifact_n1
pigtail	Thing
pigweed	plant_n2
pika	animal_n1
pile	Thing
pill	Thing
pillage	Thing
pillar	device_n1
pillory	device_n1
pillow	artifact_n1
pilot	person_n1
pilus	body_part_n1
pimple	knowledge_n1
pin	device_n1
pincer	body_part_n1
pinch	state_n4
pine	plant_n2
pineapple	plant_n2
pinecone	plant_part_n1
pinocytosis	phenomenon_n1
pint	definite_quantity_n1
pinworm	animal_n1
pinyon	plant_n2
pioneer	person_n1
pipe	artifact_n1
piper	person_n1
pipistrelle	animal_n1
piranha	person_n1
pirate	person_n1
pistachio	plant_part_n1
pistil	plant_part_n1
pistol	device_n1
piston	device_n1
pit	formation_n5
pitch	action_n1
pitcher	person_n1
pitter-patter	sound_n4
pituitary	body_part_n1
pity	feeling_n1
pivot	device_n1
pizza	food_n1
place	location_n1
placement	Thing
placenta	plant_part_n1
plague	illness_n1
plaice	fish_n1
plain	Thing
plait	Thing
plane	transport_n1
planet	heavenly_body_n1
plank	artifact_n1
plankton	organism_n1
plant	plant_n2
plantain	plant_n2
plantation	Thing
planter	person_n1
planula	animal_n1
plaque	artifact_n1
plasma	substance_n1
plasmid	Thing
plasmodium	substance_n1
plaster	substance_n1
plasterer	person_n1
plastic	substance_n1
plastid	material_n1
plate	artifact_n1
plateau	formation_n5
platelet	substance_n1
platform	artifact_n1
platinum	element_n2
platyhelminth	animal_n1
platypus	animal_n1
player	person_n1
playground	location_n1
playhouse	artifact_n1
playlist	message_n2
playroom	artifact_n1
playschool	social_group_n1
plaything	artifact_n1
playtime	period_n1
pleasure	feeling_n1
plenty	property_n3
pliers	tool_n1
plight	state_n4
plodder	person_n1
plot	knowledge_n1
plough	tool_n1
plover	bird_n1
ploy	message_n2
plug	device_n1
plum	plant_part_n1
plumage	material_n1
plumber	person_n1
plume	material_n1
plunger	person_n1
pneumonia	illness_n1
poacher	person_n1
pocket	artifact_n1
pod	Thing
poem	written_language_n1
poet	person_n1
poetry	Thing
pointer	Thing
poison	substance_n1
poisoning	state_n4
polarity	Thing
pole	artifact_n1
polecat	animal_n1
police	social_group_n1
policeman	person_n1
policewoman	person_n1
policy	process_n2
polio	illness_n1
politician	person_n1
polka	auditory_communication_n1
pollen	plant_part_n1
pollenation	event_n1
pollination	event_n1
pollinator	insect_n1
pollutant	material_n1
pollution	state_n4
polo	activity_n1
polychaete	animal_n1
polymerase	material_n1
polyp	illness_n1
polypeptide	material_n1
polysaccharide	material_n1
polystyrene	material_n1
pomegranate	plant_part_n1
pond	water_n2
pong	process_n2
pony	animal_n1
ponytail	Thing
poodle	animal_n1
pool	artifact_n1
popcorn	plant_n2
poppet	device_n1
poppy	plant_n2
population	Thing
porcelain	artifact_n1
porcupine	animal_n1
pore	shape_n2
pork	substance_n1
porker	animal_n1
porpoise	animal_n1
porridge	food_n1
port	location_n1
portion	Thing
portrait	artifact_n1
position	location_n1
possession	activity_n1
possibility	knowledge_n1
possum	animal_n1
postage	Thing
postcard	written_language_n1
postcode	written_language_n1
poster	Thing
posterior	body_part_n1
postman	person_n1
posture	property_n3
pot	artifact_n1
potassium	element_n2
potato	substance_n1
potency	quality_n1
potential	state_n4
potholder	artifact_n1
potion	food_n1
potoroo	animal_n1
potter	person_n1
potto	animal_n1
potty	artifact_n1
pouch	artifact_n1
pound	definite_quantity_n1
poverty	state_n4
powder	substance_n1
power	phenomenon_n1
pox	illness_n1
prairie	location_n1
pram	transport_n1
prayer	activity_n1
precaution	action_n1
precinct	location_n1
precipitation	phenomenon_n1
preciseness	quality_n1
predation	activity_n1
predator	animal_n1
prediction	process_n2
predisposition	state_n4
preference	feeling_n1
pregnancy	state_n4
prep	activity_n1
preparation	activity_n1
prescription	message_n2
presence	state_n4
present	Thing
presentation	activity_n1
preservation	activity_n1
president	person_n1
pressure	phenomenon_n1
prestige	state_n4
prevention	event_n1
prey	animal_n1
price	Thing
pride	feeling_n1
priest	person_n1
primate	animal_n1
prime	definite_quantity_n1
primer	artifact_n1
prince	person_n1
princess	person_n1
principal	person_n1
principle	knowledge_n1
prism	shape_n2
prison	artifact_n1
prisoner	person_n1
privacy	Thing
privet	plant_n2
prize	Thing
probability	Thing
problem	state_n4
proboscis	body_part_n1
procedure	activity_n1
process	Thing
procession	event_n1
processor	equipment_n1
producer	event_n1
product	phenomenon_n1
production	event_n1
productivity	quality_n1
profession	social_group_n1
professor	person_n1
profile	Thing
profit	Thing
progesterone	substance_n1
programme	written_language_n1
progress	action_n1
progression	Thing
projectile	device_n1
projection	process_n2
prokaryote	organism_n1
prolactin	substance_n1
proline	material_n1
prominence	state_n4
promoter	person_n1
prong	artifact_n1
pronghorn	animal_n1
proof	knowledge_n1
propeller	device_n1
property	property_n3
prophase	period_n1
proportion	Thing
proposal	message_n2
propriety	Thing
propulsion	phenomenon_n1
protection	activity_n1
protein	material_n1
protest	event_n1
protist	microorganism_n1
protocol	knowledge_n1
proton	Thing
protozoan	microorganism_n1
protractor	device_n1
protuberance	shape_n2
province	location_n1
proximity	Thing
pseudopod	body_part_n1
psychoanalysis	activity_n1
pub	building_n1
puberty	period_n1
publication	artifact_n1
pudding	food_n1
puddle	water_n2
puffball	plant_n2
puffin	bird_n1
pulley	device_n1
pullover	clothing_n1
pulp	Thing
pulse	event_n1
pumice	material_n1
pumpkin	plant_n2
pun	message_n2
pup	animal_n1
pupa	insect_n1
pupil	person_n1
puppet	artifact_n1
puppy	animal_n1
purification	action_n1
purpose	knowledge_n1
purse	artifact_n1
pursuit	action_n1
pushchair	transport_n1
puzzler	message_n2
pygmy	person_n1
pylon	artifact_n1
pyramid	shape_n2
pyrite	material_n1
pyrrhotite	material_n1
python	animal_n1
quack	person_n1
quack-quack	bird_n1
quad	body_part_n1
quake	phenomenon_n1
qualification	quality_n1
quality	quality_n1
quantifier	Thing
quantity	definite_quantity_n1
quart	definite_quantity_n1
quarter	definite_quantity_n1
quartz	substance_n1
queen	insect_n1
quest	process_n2
question	event_n1
questionnaire	written_language_n1
queue	Thing
quicksand	state_n4
quill	artifact_n1
quilt	artifact_n1
quiz	event_n1
quota	definite_quantity_n1
r	property_n3
rabbit	animal_n1
rabble	social_group_n1
rabies	illness_n1
raccoon	animal_n1
rack	artifact_n1
racket	sound_n4
racquetball	activity_n1
radar	measuring_instrument_n1
radian	definite_quantity_n1
radiation	phenomenon_n1
radicle	body_part_n1
radio	artifact_n1
radius	property_n3
radon	element_n2
raffia	material_n1
raft	artifact_n1
rag	artifact_n1
rage	feeling_n1
raglan	clothing_n1
ragweed	plant_n2
raid	activity_n1
raider	person_n1
rail	artifact_n1
railing	artifact_n1
railroad	social_group_n1
railway	social_group_n1
rain	phenomenon_n1
rainbow	shape_n2
raincoat	clothing_n1
raindrop	indefinite_quantity_n1
rainfall	phenomenon_n1
rainforest	biome_n1
rainstorm	phenomenon_n1
rainwater	material_n1
raisin	plant_part_n1
ramp	device_n1
ranch	location_n1
range	property_n3
rank	Thing
rapeseed	plant_part_n1
raptor	bird_n1
rarefaction	event_n1
rascal	person_n1
raspberry	plant_n2
rat	animal_n1
rate	Thing
ratio	Thing
ration	food_n1
rattle	sound_n4
rattlesnake	animal_n1
ravage	event_n1
ravine	formation_n5
ravioli	substance_n1
ray	phenomenon_n1
razor	tool_n1
re	Thing
reactant	material_n1
reaction	phenomenon_n1
reactivity	sense_n3
reactor	device_n1
reader	person_n1
realisation	auditory_communication_n1
reality	knowledge_n1
realization	process_n2
realm	state_n4
rear	Thing
reason	Thing
receiver	equipment_n1
receptionist	person_n1
receptiveness	Thing
receptor	body_part_n1
recipe	message_n2
recipient	person_n1
reclamation	action_n1
recollection	knowledge_n1
recommendation	message_n2
recorder	equipment_n1
recreation	activity_n1
rectangle	shape_n2
rector	person_n1
rectum	body_part_n1
redistribution	event_n1
reduction	action_n1
redwood	material_n1
reed	plant_n2
reef	formation_n5
reel	equipment_n1
ref	person_n1
referee	person_n1
reference	message_n2
referral	message_n2
refinery	artifact_n1
reflection	process_n2
reflectivity	definite_quantity_n1
reflector	device_n1
reflex	phenomenon_n1
reform	action_n1
refraction	phenomenon_n1
refrigeration	phenomenon_n1
refrigerator	artifact_n1
regeneration	phenomenon_n1
regent	person_n1
region	location_n1
regulation	message_n2
regulator	device_n1
rehearsal	activity_n1
rein	artifact_n1
reindeer	animal_n1
relatedness	Thing
relation	Thing
relative	person_n1
relativity	process_n2
reliability	Thing
relief	feeling_n1
religion	quality_n1
remediation	action_n1
remnant	Thing
remora	fish_n1
remorse	feeling_n1
removal	action_n1
renown	state_n4
repetition	event_n1
replacement	event_n1
replication	activity_n1
reporter	person_n1
representation	knowledge_n1
representative	person_n1
repressor	Thing
reproduction	phenomenon_n1
reptile	animal_n1
republic	social_group_n1
repulsion	phenomenon_n1
reputation	state_n4
requirement	event_n1
rescuer	person_n1
researcher	person_n1
resemblance	quality_n1
resentment	feeling_n1
reservoir	indefinite_quantity_n1
residence	location_n1
residue	substance_n1
resin	material_n1
resistance	phenomenon_n1
resistor	device_n1
resolution	written_language_n1
resonance	phenomenon_n1
resonator	artifact_n1
resource	quality_n1
resourcefulness	quality_n1
respiration	phenomenon_n1
response	phenomenon_n1
responsibility	event_n1
restaurant	building_n1
restraint	activity_n1
restriction	knowledge_n1
result	phenomenon_n1
retention	activity_n1
reticulum	Thing
retina	body_part_n1
reunion	social_group_n1
reversal	action_n1
revision	action_n1
revolution	event_n1
reward	event_n1
rhea	bird_n1
rhesus	animal_n1
rhino	animal_n1
rhinoceros	animal_n1
rhizoid	material_n1
rhizome	plant_part_n1
rhizomorph	material_n1
rhubarb	substance_n1
rhythm	Thing
rib	device_n1
ribbon	Thing
ribose	material_n1
ribosome	body_part_n1
rice	food_n1
riches	Thing
ricin	material_n1
rider	person_n1
ridge	formation_n5
ridley	animal_n1
rifle	device_n1
rig	equipment_n1
right	knowledge_n1
rightness	quality_n1
rigidity	property_n3
rill	water_n2
rim	shape_n2
rind	plant_part_n1
ring	property_n3
ringtail	animal_n1
ringworm	phenomenon_n1
rink	building_n1
riot	action_n1
ripple	event_n1
rite	activity_n1
river	water_n2
riverbank	formation_n5
riverbed	formation_n5
road	artifact_n1
roadrunner	bird_n1
roadside	artifact_n1
roadway	artifact_n1
robber	person_n1
robbery	activity_n1
robe	clothing_n1
robin	bird_n1
robot	device_n1
rock	Thing
rocker	person_n1
rockery	location_n1
rocket	transport_n1
rod	definite_quantity_n1
rodent	animal_n1
rodeo	activity_n1
roe	Thing
role	activity_n1
roller	action_n1
rollerskate	equipment_n1
roly-poly	person_n1
roman	Thing
roof	artifact_n1
room	artifact_n1
rooster	bird_n1
root	plant_part_n1
rope	artifact_n1
rose	plant_n2
rosemary	plant_n2
rosette	artifact_n1
rotation	action_n1
rotifer	animal_n1
rotter	person_n1
roughness	property_n3
rounder	person_n1
roundworm	phenomenon_n1
route	location_n1
routine	activity_n1
row	Thing
rowan	plant_n2
rpm	Thing
rubber	material_n1
rubbish	material_n1
rubble	material_n1
rubric	message_n2
ruby	artifact_n1
rucksack	artifact_n1
rudder	device_n1
rug	artifact_n1
rugby	activity_n1
rule	knowledge_n1
ruler	measuring_instrument_n1
rumble	sound_n4
rung	device_n1
runner	person_n1
runoff	event_n1
runway	artifact_n1
rust	material_n1
rustling	activity_n1
s	Thing
sable	artifact_n1
sac	location_n1
saddle	device_n1
saddleback	location_n1
safety	state_n4
saguaro	plant_n2
saiga	animal_n1
sail	artifact_n1
sailboat	transport_n1
sailor	person_n1
saint	knowledge_n1
sake	quality_n1
saki	food_n1
salad	food_n1
salamander	animal_n1
sale	event_n1
salinity	process_n2
saliva	substance_n1
sally	message_n2
salmon	fish_n1
salmonberry	plant_n2
salmonella	microorganism_n1
saloon	artifact_n1
salt	material_n1
saltation	Thing
saltiness	process_n2
saltwater	material_n1
salutation	message_n2
samarium	element_n2
sambar	animal_n1
sample	knowledge_n1
sanctuary	location_n1
sand	material_n1
sandal	artifact_n1
sandalwood	material_n1
sandbar	formation_n5
sander	tool_n1
sandpaper	material_n1
sandpit	formation_n5
sandstone	material_n1
sandwich	food_n1
sang	plant_n2
sarcasm	message_n2
sarcomere	Thing
sardine	substance_n1
sassaby	animal_n1
satellite	equipment_n1
satin	artifact_n1
sauce	food_n1
saucepan	artifact_n1
saucer	shape_n2
sauropod	animal_n1
sausage	substance_n1
savanna	location_n1
savannah	biome_n1
saver	person_n1
saving	action_n1
sawdust	material_n1
sawyer	person_n1
saxifrage	plant_n2
scaffold	artifact_n1
scale	measuring_instrument_n1
scallywag	person_n1
scar	knowledge_n1
scarcity	property_n3
scarecrow	artifact_n1
scarf	clothing_n1
scavenger	animal_n1
scenario	message_n2
scene	location_n1
scenery	location_n1
scent	process_n2
schedule	knowledge_n1
schematic	artifact_n1
scheme	Thing
schizophrenia	state_n4
school	social_group_n1
schoolyard	location_n1
science	knowledge_n1
scientist	person_n1
scimitar	device_n1
sclerosis	state_n4
scone	substance_n1
scoop	artifact_n1
scooter	transport_n1
scope	property_n3
score	auditory_communication_n1
scorpion	animal_n1
scour	location_n1
scrap	Thing
scraper	tool_n1
scratch	shape_n2
screeching	sound_n4
screen	artifact_n1
screw	device_n1
screwdriver	tool_n1
scrip	written_language_n1
scroll	written_language_n1
scrotum	body_part_n1
scruff	location_n1
scuba	device_n1
scuffle	event_n1
scull	transport_n1
scullery	artifact_n1
sculpture	shape_n2
scum	Thing
sea	water_n2
seabird	bird_n1
seafood	substance_n1
seagull	bird_n1
seal	device_n1
seashell	Thing
seashore	formation_n5
seaside	formation_n5
season	period_n1
seat	location_n1
seawater	material_n1
seaweed	microorganism_n1
sebum	substance_n1
sec	Thing
second	Thing
secretary	person_n1
secretion	phenomenon_n1
section	Thing
security	state_n4
sediment	substance_n1
sedimentation	phenomenon_n1
seed	plant_part_n1
seedling	plant_n2
seer	person_n1
seesaw	artifact_n1
segment	Thing
segmentation	action_n1
segregation	event_n1
seismograph	measuring_instrument_n1
seizure	event_n1
selection	action_n1
self	state_n4
self-satisfaction	feeling_n1
semen	substance_n1
senate	social_group_n1
senator	person_n1
sensation	process_n2
sense	sense_n3
sensitivity	sense_n3
sensor	device_n1
sentence	Thing
sentimentality	Thing
sepal	plant_part_n1
separation	action_n1
septum	body_part_n1
sequence	Thing
sequin	artifact_n1
sequoia	material_n1
sergeant	person_n1
series	Thing
serotine	animal_n1
serpent	animal_n1
serval	animal_n1
servant	person_n1
server	person_n1
service	activity_n1
serviceman	person_n1
serving	indefinite_quantity_n1
set	Thing
seta	body_part_n1
sett	artifact_n1
settee	artifact_n1
setting	location_n1
settler	person_n1
setup	equipment_n1
severity	property_n3
sewage	material_n1
sewer	artifact_n1
sex	property_n3
sextant	measuring_instrument_n1
shack	artifact_n1
shade	state_n4
shadow	state_n4
shaft	artifact_n1
shale	material_n1
shame	feeling_n1
shampoo	material_n1
shamrock	plant_n2
shanty	artifact_n1
shape	property_n3
shark	fish_n1
sharpness	quality_n1
shaver	tool_n1
shaving	action_n1
shawl	clothing_n1
shear	event_n1
sheath	artifact_n1
sheen	property_n3
sheep	animal_n1
sheet	shape_n2
shelf	device_n1
shell	body_part_n1
shellfish	substance_n1
shelter	artifact_n1
shepherd	person_n1
sheriff	person_n1
shield	artifact_n1
shilling	definite_quantity_n1
shin	body_part_n1
shinbone	body_part_n1
shingle	artifact_n1
ship	transport_n1
shipbuilding	activity_n1
shipwreck	transport_n1
shire	location_n1
shirt	clothing_n1
shock	feeling_n1
shoe	artifact_n1
shoelace	artifact_n1
shoot	plant_part_n1
shooter	person_n1
shop	artifact_n1
shopkeeper	person_n1
shopper	person_n1
shore	formation_n5
shorebird	bird_n1
shoreline	location_n1
shortage	property_n3
shortbread	Thing
shortness	property_n3
shot	activity_n1
shoulder	body_part_n1
shout	auditory_communication_n1
shovel	tool_n1
shower	artifact_n1
showroom	artifact_n1
shred	artifact_n1
shrew	person_n1
shrimp	substance_n1
shrub	biome_n1
shuffle	action_n1
shuttle	transport_n1
shyness	feeling_n1
sibling	person_n1
sickle	tool_n1
sickness	illness_n1
side	location_n1
siderite	material_n1
sidewalk	artifact_n1
sieve	device_n1
sigh	auditory_communication_n1
sight	sense_n3
sighting	activity_n1
sign	Thing
signal	Thing
signatory	person_n1
significance	quality_n1
signpost	Thing
sika	animal_n1
silence	state_n4
silica	material_n1
silicon	element_n2
silk	artifact_n1
silt	material_n1
silverfish	insect_n1
silverware	artifact_n1
similarity	quality_n1
simulation	knowledge_n1
singer	person_n1
single	definite_quantity_n1
sinkhole	formation_n5
sip	phenomenon_n1
sir	person_n1
siren	Thing
sis	person_n1
sister	person_n1
site	location_n1
situation	state_n4
six-pack	artifact_n1
sixpence	Thing
size	property_n3
skateboarding	activity_n1
skeleton	body_part_n1
sketch	artifact_n1
skewer	device_n1
skier	person_n1
skill	knowledge_n1
skillet	artifact_n1
skillfulness	state_n4
skin	body_part_n1
skink	animal_n1
skirt	artifact_n1
skull	body_part_n1
skunk	animal_n1
sky	Thing
skydiving	action_n1
skylight	artifact_n1
skyscraper	building_n1
slab	artifact_n1
slang	auditory_communication_n1
slate	material_n1
slave	person_n1
sled	transport_n1
sleepwalking	action_n1
sleet	phenomenon_n1
sleeve	artifact_n1
sleigh	transport_n1
slice	indefinite_quantity_n1
slide	artifact_n1
slime	substance_n1
sling	artifact_n1
slip	event_n1
slipper	artifact_n1
slit	artifact_n1
sliver	Thing
slope	formation_n5
slot	artifact_n1
sloth	animal_n1
slug	animal_n1
smallmouth	fish_n1
smasher	person_n1
smell	process_n2
smile	Thing
smirk	Thing
smith	person_n1
smog	state_n4
smoke	phenomenon_n1
smoker	person_n1
smokestack	artifact_n1
smoothie	food_n1
smoothness	property_n3
snack	food_n1
snail	animal_n1
snake	animal_n1
snakebite	state_n4
snapdragon	plant_n2
snook	fish_n1
snout	body_part_n1
snow	phenomenon_n1
snowball	artifact_n1
snowdrift	substance_n1
snowdrop	plant_n2
snowfall	phenomenon_n1
snowflake	substance_n1
snowman	artifact_n1
snowshoe	device_n1
snowstorm	phenomenon_n1
soap	material_n1
soccer	activity_n1
sociability	Thing
society	social_group_n1
sock	clothing_n1
socket	artifact_n1
soda	food_n1
sodium	element_n2
sofa	artifact_n1
softball	equipment_n1
softness	property_n3
software	written_language_n1
soil	Thing
solace	state_n4
soldier	person_n1
sole	body_part_n1
solmization	written_language_n1
solstice	Thing
solubility	quality_n1
solute	substance_n1
solution	message_n2
solvent	substance_n1
somebody	person_n1
someone	person_n1
somersault	action_n1
something	Thing
son	person_n1
sonar	measuring_instrument_n1
song	auditory_communication_n1
songbird	bird_n1
soot	element_n2
sophisticate	person_n1
sorrow	feeling_n1
sort	knowledge_n1
soul	Thing
sound	phenomenon_n1
soup	food_n1
source	location_n1
sourness	process_n2
southwest	Thing
sovereign	person_n1
soy	plant_n2
soya	plant_n2
soybean	plant_n2
space	Thing
spacecraft	equipment_n1
spaceman	person_n1
spaceship	equipment_n1
spade	tool_n1
spaghetti	substance_n1
spanner	tool_n1
spark	phenomenon_n1
sparkle	property_n3
sparkler	artifact_n1
sparrow	bird_n1
spat	event_n1
spatula	artifact_n1
spawn	Thing
speaker	person_n1
spear	device_n1
spec	message_n2
specialist	person_n1
specialization	action_n1
specialty	quality_n1
speciation	phenomenon_n1
specification	message_n2
specimen	knowledge_n1
speck	artifact_n1
spectacle	artifact_n1
spectator	person_n1
spectrum	Thing
speech	event_n1
speed	Thing
speedometer	measuring_instrument_n1
speedway	artifact_n1
spell	auditory_communication_n1
sperm	Thing
spermatid	Thing
spermatocyte	Thing
spermatogenesis	phenomenon_n1
spermatophyte	plant_n2
sphere	artifact_n1
sphincter	body_part_n1
sphinx	artifact_n1
spice	material_n1
spicule	body_part_n1
spider	animal_n1
spike	event_n1
spinach	plant_n2
spindle	material_n1
spine	body_part_n1
spinner	person_n1
spiracle	body_part_n1
spiral	shape_n2
spire	artifact_n1
spirit	Thing
spirogyra	microorganism_n1
spite	feeling_n1
spleen	body_part_n1
splinter	Thing
split	action_n1
splutter	sound_n4
spoilage	indefinite_quantity_n1
spoke	device_n1
sponge	material_n1
spoon	artifact_n1
spoonful	indefinite_quantity_n1
sporangium	plant_part_n1
spore	plant_part_n1
sporophyte	plant_n2
sporozoan	microorganism_n1
sport	activity_n1
spot	quality_n1
spreader	tool_n1
spree	action_n1
spring	period_n1
spring-cleaning	action_n1
springbok	animal_n1
springtail	insect_n1
sprinkler	device_n1
sprocket	shape_n2
spruce	plant_n2
spur	shape_n2
spy	person_n1
squabble	event_n1
squad	social_group_n1
square	shape_n2
squash	activity_n1
squeaker	artifact_n1
squid	animal_n1
squirrel	animal_n1
stability	quality_n1
stable	building_n1
stack	Thing
staff	social_group_n1
stage	period_n1
stair	device_n1
staircase	artifact_n1
stalactite	shape_n2
stalk	material_n1
stall	artifact_n1
stamen	plant_part_n1
stamina	property_n3
stance	property_n3
standard	Thing
standstill	state_n4
staphylococcus	microorganism_n1
staple	device_n1
stapler	device_n1
star	heavenly_body_n1
starch	material_n1
starfish	animal_n1
starlight	phenomenon_n1
starling	bird_n1
starter	device_n1
starvation	state_n4
state	state_n4
statement	message_n2
station	artifact_n1
statistic	knowledge_n1
statue	artifact_n1
stature	state_n4
status	state_n4
statute	written_language_n1
staurikosaurus	animal_n1
steak	substance_n1
steam	substance_n1
steamer	transport_n1
steamroller	transport_n1
steed	animal_n1
steel	substance_n1
steenbok	animal_n1
stem	plant_part_n1
step	action_n1
stepfather	person_n1
stepmother	person_n1
steppe	biome_n1
stepson	person_n1
stereo	equipment_n1
sterilization	activity_n1
sternum	body_part_n1
steroid	material_n1
stethoscope	device_n1
stew	food_n1
steward	person_n1
stick	plant_part_n1
stickleback	fish_n1
stiffness	property_n3
stigma	plant_part_n1
stile	device_n1
stillness	property_n3
stilt	device_n1
stimulant	knowledge_n1
stimulation	action_n1
stimulus	knowledge_n1
sting	state_n4
stinger	food_n1
stingray	fish_n1
stirrup	device_n1
stoat	animal_n1
stock	animal_n1
stocking	clothing_n1
stolon	plant_part_n1
stoma	shape_n2
stomach	body_part_n1
stomate	shape_n2
stone	Thing
stonefish	fish_n1
stonewort	microorganism_n1
stool	artifact_n1
stopper	artifact_n1
stopwatch	measuring_instrument_n1
storage	activity_n1
storey	artifact_n1
stork	bird_n1
storm	phenomenon_n1
story	message_n2
stove	artifact_n1
stowaway	person_n1
strainer	device_n1
strand	knowledge_n1
strap	artifact_n1
strategy	knowledge_n1
stratosphere	location_n1
stratum	location_n1
stratus	phenomenon_n1
straw	material_n1
strawberry	plant_part_n1
streak	artifact_n1
stream	water_n2
streambed	formation_n5
streamer	artifact_n1
street	artifact_n1
strength	property_n3
stress	Thing
stretch	shape_n2
stretcher	artifact_n1
stride	action_n1
strike	activity_n1
string	artifact_n1
strip	Thing
stripe	artifact_n1
stroller	transport_n1
stroma	plant_part_n1
structure	artifact_n1
stud	animal_n1
student	person_n1
studio	location_n1
stuff	material_n1
stump	plant_part_n1
stunt	action_n1
style	knowledge_n1
stylet	body_part_n1
subclass	Thing
subdivision	location_n1
subduction	Thing
subject	message_n2
sublimation	event_n1
submarine	transport_n1
subphylum	Thing
subsidence	event_n1
substance	substance_n1
substitution	event_n1
substrate	substance_n1
suburb	location_n1
success	event_n1
succession	property_n3
sucker	plant_part_n1
suds	shape_n2
sugar	food_n1
suggestion	knowledge_n1
suicide	action_n1
suit	clothing_n1
suitability	quality_n1
suitcase	artifact_n1
sulfide	material_n1
sulfur	element_n2
sulphur	element_n2
sultan	person_n1
sum	Thing
summarization	event_n1
summary	message_n2
summer	period_n1
summit	state_n4
sun	Thing
sunburn	illness_n1
sundae	food_n1
sundew	plant_n2
sunfish	substance_n1
sunflower	plant_n2
sunhat	clothing_n1
sunlight	phenomenon_n1
sunrise	knowledge_n1
sunscreen	artifact_n1
sunset	event_n1
sunshine	phenomenon_n1
sunspot	location_n1
superhighway	artifact_n1
superman	person_n1
supermarket	artifact_n1
supernova	heavenly_body_n1
superorder	Thing
superstar	person_n1
supervision	event_n1
supervisor	person_n1
supper	food_n1
supplier	person_n1
suppressor	person_n1
surf	event_n1
surface	artifact_n1
surfboarding	activity_n1
surfer	person_n1
surgery	knowledge_n1
surplus	property_n3
surprise	event_n1
surveillance	activity_n1
surveyor	person_n1
survival	state_n4
survivor	person_n1
suspension	substance_n1
suspicion	knowledge_n1
sustenance	food_n1
swab	artifact_n1
swamp	Thing
swan	bird_n1
sweater	clothing_n1
sweatshirt	clothing_n1
sweeper	person_n1
sweetener	food_n1
sweetness	process_n2
swimmer	person_n1
sword	device_n1
swordfish	substance_n1
syllable	Thing
syllabus	message_n2
symbiosis	Thing
symbol	Thing
symbolism	Thing
symmetry	property_n3
symptom	knowledge_n1
synapse	state_n4
synapsid	animal_n1
syndrome	knowledge_n1
synset	Thing
synthesis	phenomenon_n1
syphilis	illness_n1
syrup	food_n1
system	Thing
tab	artifact_n1
tabasco	Thing
table	artifact_n1
tablecloth	artifact_n1
tablespoon	indefinite_quantity_n1
tablet	Thing
tabletop	artifact_n1
tableware	artifact_n1
tach	measuring_instrument_n1
tachometer	measuring_instrument_n1
tackle	equipment_n1
tadpole	animal_n1
taffeta	artifact_n1
tag	Thing
tail	body_part_n1
tailgate	artifact_n1
takeover	event_n1
takin	animal_n1
talapoin	animal_n1
talc	material_n1
tale	message_n2
talent	knowledge_n1
tally	activity_n1
talon	body_part_n1
tamandua	animal_n1
tamarin	animal_n1
tanager	bird_n1
tangle	state_n4
tank	transport_n1
tanker	transport_n1
tantalite	material_n1
tantrum	feeling_n1
tape	measuring_instrument_n1
tapeworm	animal_n1
tapir	animal_n1
taproot	plant_part_n1
tarantula	animal_n1
target	Thing
tarsier	animal_n1
tartan	artifact_n1
task	activity_n1
taste	process_n2
taster	person_n1
tattoo	artifact_n1
tax	Thing
taxi	transport_n1
taxon	Thing
taxonomy	Thing
tayra	animal_n1
tea	food_n1
teacher	person_n1
teacup	artifact_n1
team	social_group_n1
teapot	artifact_n1
tear	indefinite_quantity_n1
teardrop	shape_n2
teaspoon	indefinite_quantity_n1
technician	person_n1
technique	knowledge_n1
technology	activity_n1
teddy	artifact_n1
tee	location_n1
teenager	person_n1
telecom	artifact_n1
telecommunication	artifact_n1
telephone	equipment_n1
telescope	device_n1
television	artifact_n1
teller	person_n1
telly	equipment_n1
telophase	period_n1
temp	person_n1
temper	Thing
temperature	property_n3
template	knowledge_n1
temple	building_n1
tenacity	Thing
tendency	knowledge_n1
tendon	body_part_n1
tendril	plant_part_n1
tenia	artifact_n1
tennis	activity_n1
tenrec	animal_n1
tension	state_n4
tent	artifact_n1
tentacle	quality_n1
term	Thing
termination	Thing
terminology	Thing
termite	insect_n1
terrace	artifact_n1
terrain	location_n1
terrapin	animal_n1
territory	location_n1
terror	feeling_n1
terry	artifact_n1
test	activity_n1
tester	person_n1
testis	body_part_n1
testosterone	substance_n1
tetanus	state_n4
tetrahymena	microorganism_n1
tetrapod	animal_n1
text	written_language_n1
textbook	artifact_n1
texture	property_n3
thatch	Thing
thaw	phenomenon_n1
theater	building_n1
theatre	building_n1
theme	message_n2
theorem	message_n2
theory	process_n2
therapsid	animal_n1
therapy	activity_n1
thermometer	measuring_instrument_n1
thermosphere	location_n1
thermostat	device_n1
theropod	animal_n1
thicket	Thing
thickness	property_n3
thief	person_n1
thigh	body_part_n1
thimble	artifact_n1
thing	Thing
thinker	person_n1
thirst	state_n4
thistle	plant_n2
thorax	body_part_n1
thorn	knowledge_n1
thoroughfare	artifact_n1
thoroughness	Thing
thought	knowledge_n1
thousand	definite_quantity_n1
thousandth	definite_quantity_n1
thrasher	device_n1
thread	artifact_n1
threat	Thing
threonine	material_n1
thrill	feeling_n1
throat	body_part_n1
throne	artifact_n1
thrush	phenomenon_n1
thumb	body_part_n1
thunder	sound_v2
thunderstorm	phenomenon_n1
thunk	sound_n4
thwack	action_n1
thymine	material_n1
thymus	body_part_n1
thyroid	body_part_n1
thyrotropin	substance_n1
thyroxine	substance_n1
ticket	written_language_n1
tide	event_n1
tiger	animal_n1
tightness	quality_n1
tightrope	artifact_n1
tile	artifact_n1
tiler	person_n1
tillage	Thing
timber	artifact_n1
timbre	property_n3
time	period_n1
timepiece	measuring_instrument_n1
timer	measuring_instrument_n1
timetable	message_n2
tin	element_n2
tint	property_n3
tip	location_n1
tiptoe	location_n1
tire	artifact_n1
tissue	body_part_n1
tit	body_part_n1
titanium	element_n2
titi	plant_n2
title	written_language_n1
toad	animal_n1
toad-in-the-hole	Thing
toadstool	plant_n2
toaster	artifact_n1
tobacco	material_n1
today	Thing
toddler	person_n1
toe	body_part_n1
toenail	body_part_n1
toffee	food_n1
toilet	artifact_n1
token	Thing
tolerance	property_n3
tom	animal_n1
tomato	substance_n1
tomb	location_n1
tombola	activity_n1
tomorrow	Thing
ton	definite_quantity_n1
tone	written_language_n1
tongue	body_part_n1
tonic	Thing
tonne	definite_quantity_n1
tonsil	body_part_n1
tool	tool_n1
tooth	body_part_n1
toothache	knowledge_n1
toothbrush	artifact_n1
toothpaste	material_n1
toothpick	tool_n1
top	location_n1
topi	clothing_n1
topic	message_n2
topsoil	material_n1
toque	clothing_n1
torch	device_n1
tornado	phenomenon_n1
torque	phenomenon_n1
tortoise	animal_n1
tot	person_n1
totality	state_n4
toucan	bird_n1
touch	event_n1
tourism	event_n1
tourist	person_n1
towel	artifact_n1
tower	artifact_n1
town	location_n1
townsfolk	social_group_n1
townspeople	social_group_n1
toxin	substance_n1
toy	artifact_n1
trachea	body_part_n1
tracheophyte	plant_n2
track	location_n1
tract	location_n1
traction	phenomenon_n1
tractor	transport_n1
trademark	quality_n1
trader	person_n1
tradition	knowledge_n1
traffic	Thing
trail	artifact_n1
trailer	person_n1
train	transport_n1
trainer	person_n1
trait	Thing
tram	transport_n1
trampoline	equipment_n1
trance	state_n4
transaction	event_n1
transcription	written_language_n1
transformation	event_n1
transfusion	action_n1
transit	device_n1
transition	action_n1
translation	Thing
transmission	action_n1
transmitter	person_n1
transparency	phenomenon_n1
transpiration	phenomenon_n1
transport	transport_n1
transportation	action_n1
trapeze	device_n1
trapper	person_n1
trash	material_n1
traveler	person_n1
traveller	person_n1
trawler	person_n1
tray	artifact_n1
treacle	food_n1
tread	artifact_n1
treasure	Thing
treatment	activity_n1
treaty	written_language_n1
tree	plant_n2
treehopper	insect_n1
treetop	location_n1
trellis	artifact_n1
trench	artifact_n1
trend	location_n1
tress	Thing
trial	activity_n1
triangle	shape_n2
tribe	social_group_n1
triceps	body_part_n1
trichomoniasis	state_n4
trick	action_n1
trickle	event_n1
tricycle	transport_n1
trigger	artifact_n1
triggerfish	fish_n1
triglyceride	material_n1
triiodothyronine	substance_n1
trilobite	animal_n1
trimming	action_n1
trinity	definite_quantity_n1
trinket	artifact_n1
trip	action_n1
triumph	event_n1
triviality	quality_n1
troll	knowledge_n1
trolley	transport_n1
trombone	device_n1
troop	social_group_n1
trooper	person_n1
trophoblast	body_part_n1
tropism	phenomenon_n1
troposphere	location_n1
trouble	knowledge_n1
trough	formation_n5
trout	substance_n1
trove	Thing
trowel	tool_n1
truck	transport_n1
truffle	plant_n2
trumpet	device_n1
trumpeter	person_n1
trunk	plant_part_n1
truth	knowledge_n1
trypsin	material_n1
tsunami	event_n1
tuatara	animal_n1
tub	artifact_n1
tuba	device_n1
tube	artifact_n1
tuber	plant_part_n1
tuberculosis	illness_n1
tubing	artifact_n1
tubule	body_part_n1
tuft	Thing
tug-of-war	event_n1
tulip	plant_n2
tum	body_part_n1
tummy	body_part_n1
tumor	illness_n1
tuna	fish_n1
tundra	biome_n1
tune	auditory_communication_n1
tungsten	element_n2
tunic	body_part_n1
tunicate	animal_n1
tunnel	artifact_n1
turban	clothing_n1
turbidity	quality_n1
turbine	device_n1
turkey	bird_n1
turnip	plant_n2
turret	artifact_n1
turtle	animal_n1
tusk	body_part_n1
tutorial	auditory_communication_n1
tv	equipment_n1
tweak	action_n1
tweezer	tool_n1
twig	plant_part_n1
twin	person_n1
twister	phenomenon_n1
type	knowledge_n1
typewriter	device_n1
tyrannosaurus	animal_n1
tyre	artifact_n1
tyrosine	material_n1
uakari	animal_n1
ulcer	state_n4
umbrella	artifact_n1
unbalance	state_n4
uncertainty	quality_n1
uncle	person_n1
undercoat	Thing
undergrowth	Thing
underside	location_n1
understudy	person_n1
underwear	clothing_n1
unemployment	state_n4
ungulate	animal_n1
unicorn	knowledge_n1
uniform	clothing_n1
uniformity	quality_n1
union	social_group_n1
unit	definite_quantity_n1
unity	state_n4
universe	Thing
university	social_group_n1
updraft	phenomenon_n1
upholstery	artifact_n1
upside	location_n1
uptake	phenomenon_n1
uracil	material_n1
uranium	element_n2
urbanization	state_n4
urchin	animal_n1
urea	material_n1
ureter	body_part_n1
urethra	body_part_n1
urgency	state_n4
urination	phenomenon_n1
urine	material_n1
usage	activity_n1
use	activity_n1
usefulness	quality_n1
user	person_n1
ut	Thing
utensil	artifact_n1
uterus	body_part_n1
utility	social_group_n1
vacation	period_n1
vaccine	substance_n1
vacuole	body_part_n1
vacuum	state_n4
vagina	body_part_n1
vagrant	person_n1
valence	quality_n1
valley	formation_n5
value	knowledge_n1
valve	body_part_n1
vampire	knowledge_n1
van	social_group_n1
vane	device_n1
vanilla	plant_n2
vapor	substance_n1
vaporization	action_n1
vapour	substance_n1
variability	quality_n1
variation	event_n1
variety	Thing
vase	artifact_n1
vector	knowledge_n1
vegetable	substance_n1
vegetarian	person_n1
vegetation	biome_n1
vehicle	transport_n1
vein	body_part_n1
velocity	Thing
velvet	artifact_n1
vena	body_part_n1
venom	substance_n1
vent	shape_n2
ventilation	action_n1
ventricle	body_part_n1
verb	Thing
vermin	person_n1
verse	Thing
version	message_n2
vertebra	body_part_n1
vertebrate	animal_n1
vesica	body_part_n1
vesicle	body_part_n1
vesper	activity_n1
vessel	artifact_n1
vet	person_n1
veteran	person_n1
vibration	event_n1
vicar	state_n4
vice	quality_n1
vicinity	location_n1
victim	person_n1
victory	event_n1
video	Thing
videotape	device_n1
viewer	device_n1
viewpoint	location_n1
vigor	property_n3
vigour	property_n3
village	social_group_n1
villager	person_n1
villain	person_n1
villus	body_part_n1
vine	plant_n2
vinegar	food_n1
vinyl	Thing
violence	action_n1
violet	plant_n2
violin	device_n1
viper	animal_n1
virago	person_n1
virgin	person_n1
virion	Thing
virus	microorganism_n1
viscacha	animal_n1
viscosity	property_n3
visibility	property_n3
vision	sense_n3
visitor	person_n1
visor	artifact_n1
vitamin	food_n1
vocabulary	artifact_n1
vocalization	Thing
vocation	activity_n1
voice	property_n3
volcano	shape_n2
vole	animal_n1
volleyball	activity_n1
volt	definite_quantity_n1
voltage	phenomenon_n1
volume	Thing
voyage	action_n1
vulture	bird_n1
vulva	body_part_n1
wagon	transport_n1
wagtail	bird_n1
waist	body_part_n1
waiter	person_n1
waitress	person_n1
wale	state_n4
walker	artifact_n1
wall	artifact_n1
wallaby	animal_n1
wallet	artifact_n1
wallpaper	material_n1
walnut	plant_part_n1
walrus	animal_n1
wand	artifact_n1
war	event_n1
warbler	bird_n1
ward	person_n1
warden	person_n1
wardrobe	artifact_n1
warmth	process_n2
warning	event_n1
warren	formation_n5
warrior	person_n1
wart	shape_n2
washbasin	artifact_n1
washer	person_n1
washing-up	activity_n1
wasp	insect_n1
waste	material_n1
wastewater	material_n1
water	material_n1
waterbuck	animal_n1
watercress	substance_n1
waterfall	water_n2
waterfowl	bird_n1
watermelon	plant_part_n1
waters	water_n2
waterway	water_n2
waterwheel	device_n1
watt	definite_quantity_n1
wave	event_n1
wavelength	Thing
wax	material_n1
waxwork	plant_n2
way	property_n3
weakness	state_n4
wealth	state_n4
weapon	device_n1
weaponry	artifact_n1
wearer	person_n1
weasel	animal_n1
weather	phenomenon_n1
weatherman	person_n1
weaver	person_n1
web	Thing
webbing	artifact_n1
wedding	event_n1
wedge	shape_n2
weed	plant_n2
week	period_n1
weekday	period_n1
weekend	period_n1
weevil	insect_n1
weight	property_n3
weightlessness	property_n3
weightlifter	person_n1
weir	artifact_n1
wellbeing	state_n4
wellness	state_n4
west	Thing
wetland	Thing
wetness	state_n4
whale	animal_n1
wheat	plant_n2
wheel	device_n1
wheelbarrow	transport_n1
wheelchair	artifact_n1
while	period_n1
whip	device_n1
whiptail	animal_n1
whirligig	artifact_n1
whisk	artifact_n1
whisker	body_part_n1
whit	indefinite_quantity_n1
whorl	shape_n2
wick	artifact_n1
widow	person_n1
width	property_n3
wife	person_n1
wig	clothing_n1
wildcat	artifact_n1
wildebeest	animal_n1
wilderness	location_n1
wildfire	event_n1
wildflower	plant_n2
wildlife	Thing
will	written_language_n1
willow	plant_n2
wimp	person_n1
wind	phenomenon_n1
windmill	device_n1
window	artifact_n1
windowpane	artifact_n1
windowsill	device_n1
windpipe	body_part_n1
windshield	artifact_n1
windstorm	phenomenon_n1
wine	food_n1
wing	body_part_n1
winkle	animal_n1
winner	person_n1
winter	period_n1
wiper	device_n1
wire	artifact_n1
wisent	animal_n1
wishbone	body_part_n1
wit	message_n2
witch	person_n1
withdrawal	event_n1
withe	device_n1
witness	person_n1
wizard	person_n1
wolf	animal_n1
wolverine	animal_n1
woman	person_n1
womb	body_part_n1
wombat	animal_n1
wood	material_n1
woodchuck	animal_n1
woodcutter	person_n1
woodland	biome_n1
woodlouse	animal_n1
woodpecker	bird_n1
woodwind	device_n1
woodwork	artifact_n1
woof	sound_n4
wool	artifact_n1
word	Thing
wordnet	message_n2
workbench	artifact_n1
worker	person_n1
workman	person_n1
workout	activity_n1
workplace	location_n1
workshop	activity_n1
world	Thing
worm	animal_n1
worrier	person_n1
worship	activity_n1
wort	plant_n2
worth	indefinite_quantity_n1
wound	state_n4
wrapping	artifact_n1
wreath	artifact_n1
wreckage	Thing
wren	bird_n1
wrinkle	shape_n2
wrist	body_part_n1
wristwatch	measuring_instrument_n1
writer	person_n1
xerophyte	plant_n2
xylem	plant_part_n1
yacht	transport_n1
yak	animal_n1
yard	location_n1
year	period_n1
yeast	substance_n1
yes	message_n2
yesterday	Thing
yew	material_n1
yin	knowledge_n1
yo-yo	artifact_n1
yoga	quality_n1
yoghurt	food_n1
yogi	person_n1
yogurt	food_n1
yolk	food_n1
zag	shape_n2
zeal	feeling_n1
zebra	animal_n1
zed	Thing
zero	Thing
zig	shape_n2
zinc	element_n2
zing	sound_n4
zipper	device_n1
zone	location_n1
zoo	artifact_n1
zooplankton	animal_n1
zygospore	plant_part_n1
zygote	Thing
